PUNC	PUNC	PUNC
DET	DET	DET
NOUN_QUANT+CASE_DEF_ACC	NOUNQUANT	NOUNQUANT
IVSUFF_DO:1S	PRPS1	PRPS
ADJ+NSUFF_FEM_DU_NOM_POSS	JJFD	JJFD
PVSUFF_DO:2MP	PRPMP2	PRPMP
PV_PASS+PVSUFF_SUBJ:1P	VBN+SP1	VBN+SP
NOUN_QUANT+NSUFF_MASC_DU_GEN	NOUNQUANTMD	NOUNQUANTMD
IV3FP+IV+IVSUFF_SUBJ:FP	VBPFP3+SFP	VBPFP+SFP
ADJ_NUM+CASE_DEF_NOM	ADJNUM	ADJNUM
NOUN_PROP+NSUFF_FEM_SG+CASE_INDEF_GEN	NNPFS	NNPFS
NOUN+NSUFF_FEM_PL+CASE_INDEF_GEN	NNSFP	NNSFP
ADJ.VN+NSUFF_FEM_SG+CASE_INDEF_GEN	VNFS	VNFS
NOUN.VN+NSUFF_FEM_SG+CASE_DEF_ACC	VBGFS	VBGFS
IV1S+IV	VBPS1+S	VBPS+S
CONNEC_PART	RP	RP
NOUN.VN+NSUFF_FEM_PL+CASE_DEF_NOM	VBGFP	VBGFP
NOUN_QUANT+NSUFF_FEM_SG+CASE_DEF_ACC	NOUNQUANTFS	NOUNQUANTFS
IVSUFF_DO:3D	PRPD3	PRPD
INTERJ	UH	UH
NOUN_NUM+NSUFF_FEM_SG+CASE_INDEF_NOM	CDFS	CDFS
FOCUS_PART	RP	RP
ADJ.VN+NSUFF_MASC_PL_NOM	VNMP	VNMP
DEM_PRON_MS	DTMS	DTMS
ADJ_COMP+CASE_DEF_ACC	JJR	JJR
NOUN+NSUFF_FEM_SG+CASE_INDEF_GEN	NNFS	NNFS
NOUN+NSUFF_MASC_PL_GEN	NNSMP	NNSMP
NOUN_NUM+NSUFF_FEM_PL+CASE_DEF_NOM	CDFP	CDFP
VERB_PART	RP	RP
ADJ.VN+NSUFF_FEM_SG	VNFS	VNFS
NOUN+NSUFF_FEM_DU_NOM	NNSFD	NNSFD
NOUN_NUM+CASE_INDEF_ACC	CD	CD
NOUN+CASE_INDEF_ACC	NN	NN
PREP+NOUN+CASE_INDEF_ACC	NN	NN
NOUN_NUM+NSUFF_MASC_PL_GEN	CDMP	CDMP
POSS_PRON_3FS	PRP$FS3	PRP$FS
IVSUFF_DO:1P	PRPP1	PRPP
NOUN+NSUFF_MASC_DU_NOM	NNSMD	NNSMD
NOUN+NSUFF_MASC_PL_GEN_POSS	NNSMP	NNSMP
NOUN+NSUFF_FEM_PL+CASE_DEF_ACCGEN	NNSFP	NNSFP
PV+PVSUFF_SUBJ:1P	VBD+SP1	VBD+SP
PRON_2FP	PRPFP2	PRPFP
NOUN_NUM+NSUFF_MASC_DU_ACCGEN_POSS	CDMD	CDMD
POSS_PRON_2FS	PRP$FS2	PRP$FS
ADJ+NSUFF_FEM_PL+CASE_INDEF_GEN	JJFP	JJFP
FUT+IV3MP+IV+IVSUFF_SUBJ:MP_MOOD:I	VBPMP3+SMP	VBPMP+SMP
PV+PVSUFF_SUBJ:3MP	VBD+SMP3	VBD+SMP
ADJ+CASE_INDEF_ACC	JJ	JJ
NOUN	NN	NN
GRAMMAR_PROBLEM	NN	NN
INTERROG_PART	RP	RP
ADJ+CASE_INDEF_GEN	JJ	JJ
NOUN+NSUFF_FEM_PL+CASE_INDEF_NOM	NNSFP	NNSFP
NOUN_PROP+NSUFF_MASC_DU_ACCGEN	NNPSMD	NNPSMD
ADJ+NSUFF_FEM_SG+CASE_INDEF_NOM	JJFS	JJFS
NOUN_PROP+CASE_INDEF_GEN	NNP	NNP
ADJ.VN+NSUFF_FEM_SG+CASE_DEF_GEN	VNFS	VNFS
NOUN+NSUFF_FEM_SG+CASE_INDEF_NOM	NNFS	NNFS
POSS_PRON_2MS	PRP$MS2	PRP$MS
POSS_PRON_2D	PRP$MS2	PRP$MS
PRON_3MS	PRPMP3	PRPMP
IV2MS+IV+IVSUFF_MOOD:S	VBPMS2+S	VBPMS+S
ADJ+NSUFF_MASC_DU_ACCGEN	JJMD	JJMD
ADJ+NSUFF_MASC_DU_ACC_POSS	JJMD	JJMD
ADJ.VN+CASE_DEF_GEN	VN	VN
IV3FS+IV+IVSUFF_SUBJ:3FS	VBPFS3+SFS3	VBPFS+SFS
DEM_PRON	DT	DT
DEM_PRON_P	DT	DT
IVSUFF_DO:3MP	PRPMP3	PRPMP
PVSUFF_DO:3FS	PRPFS3	PRPFS
ADJ+NSUFF_FEM_PL+CASE_DEF_ACC	JJFP	JJFP
NOUN+NSUFF_FEM_PL+CASE_DEF_ACC	NNSFP	NNSFP
IV3MP+IV+IVSUFF_MOOD:S	VBPMP3+S	VBPMP+S
ADJ.VN+NSUFF_FEM_PL+CASE_DEF_NOM	VNFP	VNFP
ADJ_NUM+CASE_INDEF_GEN	ADJNUM	ADJNUM
DEM_PRON_MP	DTMP	DTMP
IV3MP+IV+IVSUFF_SUBJ:MP_MOOD:I	VBPMP3+SMP	VBPMP+SMP
EMPHATIC_PART	RP	RP
NOUN+NSUFF_FEM_DU_ACCGEN	NNSFD	NNSFD
IV	VBP+S	VBP+S
IV3MS+IV_PASS+IVSUFF_MOOD:J	VBNMS3+S	VBNMS+S
IV3FS+IV+IVSUFF_MOOD:J	VBPFS3+S	VBPFS+S
ADJ+NSUFF_MASC_PL_ACCGEN_POSS	JJMP	JJMP
ADJ+NSUFF_MASC_DU_ACC	JJMD	JJMD
NOUN.VN+NSUFF_FEM_DU_GEN	VBGFD	VBGFD
ADJ.VN+CASE_INDEF_GEN	VN	VN
NOUN_PROP+CASE_INDEF_ACC	NNP	NNP
PREP+NOUN_PROP	NNP	NNP
PREP+NOUN	NNP	NNP
NOUN_QUANT+CASE_INDEF_ACC	NOUNQUANT	NOUNQUANT
PV_PASS+PVSUFF_SUBJ:1S	VBN+SS1	VBN+SS
ADJ+NSUFF_FEM_SG+CASE_DEF_GEN	JJFS	JJFS
NOUN+NSUFF_MASC_DU_ACC_POSS	NNSMD	NNSMD
NOUN_NUM+NSUFF_FEM_SG+CASE_DEF_GEN	CDFS	CDFS
ADJ.VN+CASE_DEF_NOM	VN	VN
PRON_2MS	PRPMP2	PRPMP
IV3FS+IV_PASS+IVSUFF_MOOD:I	VBNFS3+S	VBNFS+S
ADJ+NSUFF_FEM_SG+CASE_INDEF_GEN	JJFS	JJFS
NOUN+NSUFF_MASC_DU_ACCGEN	NNSMD	NNSMD
PV+PVSUFF_SUBJ:2FS	VBD+SFS2	VBD+SFS
ADJ+NSUFF_MASC_PL_NOM_POSS	JJMP	JJMP
ADJ_NUM+CASE_DEF_GEN	ADJNUM	ADJNUM
ADJ_COMP+CASE_INDEF_GEN	JJR	JJR
ADJ+NSUFF_MASC_PL_ACC_POSS	JJMP	JJMP
ADJ_NUM+NSUFF_FEM_SG	ADJNUMFS	ADJNUMFS
IV1P+IV_PASS+IVSUFF_MOOD:I	VBNP1+S	VBNP+S
NOUN_QUANT+NSUFF_FEM_SG+CASE_DEF_GEN	NOUNQUANTFS	NOUNQUANTFS
NOUN+NSUFF_FEM_PL+CASE_INDEF_ACCGEN	NNSFP	NNSFP
NOUN+NSUFF_FEM_PL+CASE_DEF_NOM	NNSFP	NNSFP
PV_PASS+PVSUFF_SUBJ:3FD	VBN+SFD3	VBN+SFD
ADJ.VN+CASE_DEF_ACC	VN	VN
ADJ.VN+NSUFF_FEM_PL+CASE_DEF_GEN	VNFP	VNFP
PV+PVSUFF_SUBJ:3FS	VBD+SFS3	VBD+SFS
PREP+PV+PVSUFF_SUBJ:3FS	VBD+SFS3	VBD+SFS
FUT+IV3FD+IV+IVSUFF_SUBJ:D_MOOD:I	VBPFD3+SD	VBPFD+SD
NOUN_NUM+NSUFF_FEM_PL+CASE_DEF_ACCGEN	CDFP	CDFP
FUT+IV3FS+IV_PASS+IVSUFF_MOOD:I	VBNFS3+S	VBNFS+S
ADJ.VN+NSUFF_MASC_DU_NOM_POSS	VNMD	VNMD
NOUN.VN	VBG	VBG
NOUN+NSUFF_MASC_DU_GEN	NNSMD	NNSMD
NOUN_NUM+NSUFF_MASC_DU_GEN	CDMD	CDMD
FUT+IV3MD+IV+IVSUFF_SUBJ:D_MOOD:I	VBPMD3+SD	VBPMD+SD
POSS_PRON_3MP	PRP$MP3	PRP$MP
PV+PVSUFF_SUBJ:1S	VBD+SS1	VBD+SS
IV1S+IV_PASS+IVSUFF_MOOD:I	VBNS1+S	VBNS+S
NOUN+NSUFF_MASC_PL_ACC	NNSMP	NNSMP
REL_PRON+CASE_DEF_GEN	WP	WP
NOUN_NUM+NSUFF_MASC_PL_NOM	CDMP	CDMP
PVSUFF_DO:2FS	PRPFS2	PRPFS
ADJ+CASE_DEF_ACC	JJ	JJ
ADJ.VN+NSUFF_FEM_DU_ACC	VNFD	VNFD
NOUN_PROP+NSUFF_FEM_PL+CASE_DEF_GEN	NNPSFP	NNPSFP
ADJ_NUM+CASE_INDEF_NOM	ADJNUM	ADJNUM
IV3MS+IV	VBPMS3+S	VBPMS+S
JUS+IV1P+IV+IVSUFF_MOOD:J	VBPP1+S	VBPP+S
NOUN_PROP+NSUFF_FEM_SG+CASE_DEF_GEN	NNPFS	NNPFS
INTERROG_PRON	WP	WP
NOUN_PROP+CASE_INDEF_NOM	NNP	NNP
IV3MP+IV+IVSUFF_SUBJ:MP_MOOD:SJ	VBPMP3+SMP	VBPMP+SMP
NOUN_NUM+NSUFF_MASC_DU_ACC_POSS	CDMD	CDMD
NOUN_NUM+NSUFF_MASC_DU_ACC	CDMD	CDMD
ADJ_COMP	JJR	JJR
ADJ.VN+NSUFF_MASC_PL_ACC	VNMP	VNMP
NOUN.VN+NSUFF_FEM_SG+CASE_INDEF_ACC	VBGFS	VBGFS
NOUN+CASE_INDEF_NOM	NN	NN
IV3FS+IV	VBPFS3+S	VBPFS+S
ADJ_NUM+NSUFF_FEM_SG+CASE_INDEF_GEN	ADJNUMFS	ADJNUMFS
CV	VB+S	VB+S
NOUN_PROP+NSUFF_FEM_SG+CASE_INDEF_ACC	NNPFS	NNPFS
PV+PVSUFF_SUBJ:3MS	VBD+SMS3	VBD+SMS
PREP+PV+PVSUFF_SUBJ:3MS	VBD+SMS3	VBD+SMS
IV1S+IV+IVSUFF_MOOD:S	VBPS1+S	VBPS+S
ADJ+NSUFF_MASC_DU_GEN_POSS	JJMD	JJMD
ADJ_COMP+NSUFF_FEM_SG+CASE_INDEF_NOM	JJRFS	JJRFS
NOUN.VN+NSUFF_FEM_SG	VBGFS	VBGFS
JUS+IV3MS+IV_PASS+IVSUFF_MOOD:J	VBNMS3+S	VBNMS+S
NOUN+NSUFF_FEM_SG	NNFS	NNFS
NOUN_PROP+NSUFF_FEM_PL+CASE_DEF_ACCGEN	NNPSFP	NNPSFP
NOUN_PROP	NNP	NNP
TYPO	NN	NN
CVSUFF_DO:1P	PRPP1	PRPP
JUS+IV2FS+IV+IVSUFF_SUBJ:2FS_MOOD:SJ	VBPFS2+SFS2	VBPFS+SFS
NOUN+NSUFF_FEM_DU_GEN_POSS	NNSFD	NNSFD
PV+PVSUFF_3MS	VBD+S	VBD+S
PRON_3MP	PRPMP3	PRPMP
PVSUFF_DO:3MS	PRPMS3	PRPMS
IV2FP+IV+IVSUFF_SUBJ:FP	VBPFP2+SFP	VBPFP+SFP
RC_PART	RP	RP
NOUN_PROP+NSUFF_FEM_DU_GEN	NNPSFD	NNPSFD
NOUN.VN+NSUFF_MASC_PL_ACCGEN	VBGMP	VBGMP
NOUN+NSUFF_MASC_PL_ACCGEN	NNSMP	NNSMP
NOUN_QUANT+CASE_DEF_NOM	NOUNQUANT	NOUNQUANT
ADJ_COMP+CASE_INDEF_NOM	JJR	JJR
ADJ+NSUFF_MASC_PL_GEN_POSS	JJMP	JJMP
NOUN+NSUFF_FEM_SG+CASE_DEF_GEN	NNFS	NNFS
PREP+NOUN+NSUFF_FEM_SG+CASE_DEF_ACC	NNFS	NNFS
PREP+NOUN+NSUFF_FEM_SG+CASE_DEF_NOM	NNFS	NNFS
NOUN_PROP+NSUFF_MASC_DU_GEN	NNPSMD	NNPSMD
ADJ_COMP+NSUFF_MASC_DU_GEN	JJRMD	JJRMD
NOUN_NUM+NSUFF_MASC_DU_NOM_POSS	CDMD	CDMD
NOUN_PROP+NSUFF_FEM_PL+CASE_INDEF_ACCGEN	NNPSFP	NNPSFP
NOUN+NSUFF_FEM_PL	NNSFP	NNSFP
NOUN_NUM+NSUFF_FEM_SG+CASE_DEF_ACC	CDFS	CDFS
POSS_PRON_1P	PRP$P1	PRP$P
ABBREV	NN	NN
IV1P+IV	VBPP1+S	VBPP+S
CONJ	CC	CC
REL_PRON+CASE_DEF_ACC	WP	WP
NOUN_PROP+NSUFF_MASC_PL_GEN_POSS	NNPSMP	NNPSMP
ADJ.VN+NSUFF_MASC_PL_ACCGEN	VNMP	VNMP
NOUN.VN+NSUFF_MASC_DU_GEN	VBGMD	VBGMD
PVSUFF_DO:3MP	PRPMP3	PRPMP
ADJ+NSUFF_FEM_DU_GEN	JJFD	JJFD
ADJ.VN+CASE_INDEF_ACC	VN	VN
IV3MS+IV_PASS+IVSUFF_MOOD:S	VBNMS3+S	VBNMS+S
NOUN+NSUFF_MASC_PL_NOM	NNSMP	NNSMP
IV2MS+IV	VBPMS2+S	VBPMS+S
NOUN+NSUFF_MASC_PL_ACCGEN_POSS	NNSMP	NNSMP
NOUN.VN+NSUFF_FEM_PL+CASE_DEF_GEN	VBGFP	VBGFP
IV2MS+IV+IVSUFF_MOOD:J	VBPMS2+S	VBPMS+S
NOUN+NSUFF_MASC_PL_ACC_POSS	NNSMP	NNSMP
NOUN+CASE_DEF_GEN	NN	NN
IV2D+IV+IVSUFF_SUBJ:D_MOOD:SJ	VBPD2+SD	VBPD+SD
NOUN+NSUFF_MASC_DU_NOM_POSS	NNSMD	NNSMD
IV3MS+IV_PASS+IVSUFF_MOOD:I	VBNMS3+S	VBNMS+S
ADJ+NSUFF_FEM_PL+CASE_DEF_GEN	JJFP	JJFP
ADJ+NSUFF_MASC_DU_NOM	JJMD	JJMD
NOUN_QUANT+NSUFF_FEM_SG+CASE_INDEF_GEN	NOUNQUANTFS	NOUNQUANTFS
FOREIGN	NN	NN
NOUN_NUM+NSUFF_FEM_PL+CASE_DEF_GEN	CDFP	CDFP
ADJ_NUM+NSUFF_MASC_DU_NOM	ADJNUMMD	ADJNUMMD
NOUN.VN+CASE_INDEF_NOM	VBG	VBG
ADJ.VN+NSUFF_FEM_DU_GEN	VNFD	VNFD
LATIN	NN	NN
ADJ+NSUFF_FEM_DU_ACC	JJFD	JJFD
NOUN+NSUFF_MASC_DU_GEN_POSS	NNSMD	NNSMD
NOUN.VN+CASE_DEF_GEN	VBG	VBG
IV3FS+IV_PASS+IVSUFF_MOOD:J	VBNFS3+S	VBNFS+S
IV+IVSUFF_SUBJ:3FS	VBP+SFS3	VBP+SFS
NOUN.VN+NSUFF_FEM_SG+CASE_INDEF_NOM	VBGFS	VBGFS
FUT+IV3MS+IV_PASS+IVSUFF_MOOD:S	VBNMS3+S	VBNMS+S
NOUN.VN+CASE_INDEF_GEN	VBG	VBG
CV+CVSUFF_SUBJ:2FS	VB+SFS2	VB+SFS
PRON_2FS	PRPFP2	PRPFP
JUS+IV3MS+IV+IVSUFF_MOOD:J	VBPMS3+S	VBPMS+S
PVSUFF_DO:1P	PRPP1	PRPP
PART	RP	RP
NOUN_NUM+CASE_DEF_GEN	CD	CD
POSS_PRON_2FP	PRP$FP2	PRP$FP
VERB	VBP+S	VBP+S
NOUN_PROP+NSUFF_FEM_SG+CASE_INDEF_NOM	NNPFS	NNPFS
NOUN_QUANT+CASE_DEF_GEN	NOUNQUANT	NOUNQUANT
IV2MS+IV_PASS+IVSUFF_MOOD:S	VBNMS2+S	VBNMS+S
NOUN_PROP+NSUFF_FEM_PL+CASE_INDEF_GEN	NNPSFP	NNPSFP
PRON_1S	PRPP1	PRPP
VOC_PART	RP	RP
ADJ+NSUFF_FEM_PL+CASE_INDEF_ACCGEN	JJFP	JJFP
ADJ+NSUFF_FEM_PL+CASE_INDEF_NOM	JJFP	JJFP
NOUN_PROP+NSUFF_FEM_SG+CASE_DEF_NOM	NNPFS	NNPFS
ADJ+NSUFF_FEM_PL	JJFP	JJFP
JUS+IV2MS+IV+IVSUFF_MOOD:J	VBPMS2+S	VBPMS+S
POSS_PRON_2MP	PRP$MP2	PRP$MP
NOUN.VN+NSUFF_FEM_DU_ACC	VBGFD	VBGFD
NOUN+NSUFF_FEM_DU_GEN	NNSFD	NNSFD
PRON	PRPP	PRPP
IVSUFF_DO:2MS	PRPMS2	PRPMS
IV3MP+IV+IVSUFF_MOOD:I	VBPMP3+S	VBPMP+S
NOUN_NUM+NSUFF_FEM_SG+CASE_INDEF_GEN	CDFS	CDFS
PVSUFF_DO:2MS	PRPMS2	PRPMS
DEM_PRON_F	DTF	DTF
JUS+IV3MP+IV+IVSUFF_MOOD:J	VBPMP3+S	VBPMP+S
ADJ_NUM	ADJNUM	ADJNUM
ADJ.VN+NSUFF_FEM_SG+CASE_DEF_ACC	VNFS	VNFS
NOUN+NSUFF_FEM_PL+CASE_INDEF_ACC	NNSFP	NNSFP
ADJ+CASE_DEF_NOM	JJ	JJ
NOUN_QUANT+NSUFF_MASC_DU_GEN_POSS	NOUNQUANTMD	NOUNQUANTMD
PV_PASS+PVSUFF_SUBJ:3MS	VBN+SMS3	VBN+SMS
PREP+PV_PASS+PVSUFF_SUBJ:3MS	VBN+SMS3	VBN+SMS
ADJ+NSUFF_FEM_SG+CASE_INDEF_ACC	JJFS	JJFS
ADJ+NSUFF_FEM_SG+CASE_DEF_ACC	JJFS	JJFS
NOUN.VN+CASE_DEF_NOM	VBG	VBG
REL_PRON+NSUFF_FEM_SG+CASE_DEF_GEN	WPFS	WPFS
IV3FS+IV+IVSUFF_MOOD:S	VBPFS3+S	VBPFS+S
ADJ_NUM+NSUFF_FEM_PL+CASE_DEF_GEN	ADJNUMFP	ADJNUMFP
NOUN_NUM+NSUFF_MASC_PL_ACC	CDMP	CDMP
CV+CVSUFF_SUBJ:2MP	VB+SMP2	VB+SMP
NOUN+NSUFF_FEM_DU_ACCGEN_POSS	NNSFD	NNSFD
IVSUFF_DO:2FS	PRPFS2	PRPFS
NOUN.VN+NSUFF_FEM_PL+CASE_DEF_ACCGEN	VBGFP	VBGFP
ADJ_NUM+NSUFF_FEM_SG+CASE_INDEF_ACC	ADJNUMFS	ADJNUMFS
NOUN_NUM+NSUFF_FEM_DU_ACC	CDFD	CDFD
NOUN+NSUFF_FEM_DU_NOM_POSS	NNSFD	NNSFD
PV+PVSUFF_SUBJ:3FP	VBD+SFP3	VBD+SFP
PREP+PV+PVSUFF_SUBJ:3FP	VBD+SFP3	VBD+SFP
ADJ.VN+CASE_INDEF_NOM	VN	VN
NOUN_PROP+NSUFF_MASC_PL_GEN	NNPSMP	NNPSMP
NOUN_NUM+CASE_DEF_NOM	CD	CD
FUT+IV3MP+IV_PASS+IVSUFF_SUBJ:MP_MOOD:I	VBNMP3+SMP	VBNMP+SMP
DEM_PRON_FD	DTFD	DTFD
IV2MS+IV_PASS+IVSUFF_MOOD:I	VBNMS2+S	VBNMS+S
NOUN_NUM+NSUFF_FEM_PL+CASE_DEF_ACC	CDFP	CDFP
NOUN_QUANT+CASE_INDEF_GEN	NOUNQUANT	NOUNQUANT
PRON_3FP	PRPFP3	PRPFP
PRON_2MP	PRPMP2	PRPMP
SUB_CONJ	IN	IN
ADJ_COMP+NSUFF_MASC_PL_GEN	JJRMP	JJRMP
PREP	IN	IN
ADJ+NSUFF_FEM_DU_ACCGEN	JJFD	JJFD
NOUN+NSUFF_FEM_SG+CASE_DEF_ACC	NNFS	NNFS
PV	VBD+S	VBD+S
ADJ.VN+NSUFF_MASC_DU_GEN	VNMD	VNMD
FUT+IV1S+IV+IVSUFF_MOOD:I	VBPS1+S	VBPS+S
IV1S+IV+IVSUFF_MOOD:J	VBPS1+S	VBPS+S
IV1P+IV+IVSUFF_MOOD:S	VBPP1+S	VBPP+S
NOUN.VN+CASE_DEF_ACC	VBG	VBG
IV1P+IV+IVSUFF_MOOD:J	VBPP1+S	VBPP+S
ADJ+NSUFF_MASC_DU_GEN	JJMD	JJMD
FUT+IV2MP+IV+IVSUFF_SUBJ:MP_MOOD:I	VBPMP2+SMP	VBPMP+SMP
POSS_PRON_1S	PRP$S1	PRP$S
FUT_PART	RP	RP
ADJ+NSUFF_FEM_PL+CASE_DEF_ACCGEN	JJFP	JJFP
ADJ+NSUFF_MASC_PL_NOM	JJMP	JJMP
ADJ_NUM+NSUFF_MASC_PL_GEN	ADJNUMMP	ADJNUMMP
NUMERIC_COMMA	PUNC	PUNC
IV2MP+IV+IVSUFF_SUBJ:MP_MOOD:I	VBPMP2+SMP	VBPMP+SMP
IVSUFF_DO:2MP	PRPMP2	PRPMP
ADJ+NSUFF_MASC_PL_ACCGEN	JJMP	JJMP
NOUN+CASE_INDEF_GEN	NN	NN
PV_PASS	VBN+S	VBN+S
ADJ_NUM+CASE_INDEF_ACC	ADJNUM	ADJNUM
IV3MP+IV_PASS+IVSUFF_MOOD:I	VBNMP3+S	VBNMP+S
ADV	RB	RB
NOUN_QUANT+NSUFF_FEM_SG+CASE_DEF_NOM	NOUNQUANTFS	NOUNQUANTFS
IV1P+IV_PASS+IVSUFF_MOOD:S	VBNP1+S	VBNP+S
NOUN+NSUFF_MASC_DU_ACC	NNSMD	NNSMD
NOUN_PROP+CASE_DEF_GEN	NNP	NNP
PV+PVSUFF_SUBJ:3MD	VBD+SMD3	VBD+SMD
NOUN+NSUFF_MASC_SG_ACC_INDEF	NNMS	NNMS
NOUN+NSUFF_MASC_DU	NNSMD	NNSMD
JUS_PART	RP	RP
ADJ_NUM+NSUFF_FEM_DU_GEN	ADJNUMFD	ADJNUMFD
ADJ.VN+NSUFF_FEM_SG+CASE_INDEF_NOM	VNFS	VNFS
ADJ+NSUFF_MASC_DU_ACCGEN_POSS	JJMD	JJMD
CV+CVSUFF_SUBJ:2MS	VB+SMS2	VB+SMS
IV2D+IV+IVSUFF_SUBJ:D_MOOD:I	VBPD2+SD	VBPD+SD
NOUN.VN+NSUFF_MASC_PL_ACC	VBGMP	VBGMP
NOUN_QUANT+NSUFF_FEM_SG+CASE_INDEF_ACC	NOUNQUANTFS	NOUNQUANTFS
PRON_2D	PRPP2	PRPP
ADJ+NSUFF_FEM_DU_ACCGEN_POSS	JJFD	JJFD
ADJ_NUM+NSUFF_FEM_SG+CASE_DEF_ACC	ADJNUMFS	ADJNUMFS
ADJ_NUM+NSUFF_MASC_DU_ACC	ADJNUMMD	ADJNUMMD
ADJ_NUM+NSUFF_FEM_SG+CASE_DEF_NOM	ADJNUMFS	ADJNUMFS
NOUN+NSUFF_FEM_SG+CASE_DEF_NOM	NNFS	NNFS
ADJ_COMP+CASE_INDEF_ACC	JJR	JJR
NOUN+NSUFF_FEM_DU_ACC	NNSFD	NNSFD
FUT+IV1P+IV+IVSUFF_MOOD:I	VBPP1+S	VBPP+S
ADJ+NSUFF_MASC_DU_NOM_POSS	JJMD	JJMD
IV_PASS	VBN+S	VBN+S
ADJ+NSUFF_FEM_SG+CASE_DEF_NOM	JJFS	JJFS
CVSUFF_DO:3FS	PRPFS3	PRPFS
NOUN+NSUFF_MASC_PL_NOM_POSS	NNSMP	NNSMP
NOUN_PROP+NSUFF_MASC_PL_ACC	NNPSMP	NNPSMP
IV1S+IV_PASS+IVSUFF_MOOD:S	VBNS1+S	VBNS+S
INTERROG_PRON+CASE_DEF_NOM	WP	WP
INTERROG_PRON+CASE_DEF_ACC	WP	WP
INTERROG_PRON+NSUFF_FEM_SG+CASE_DEF_NOM	WP	WP
INTERROG_PRON+CASE_INDEF_ACC	WP	WP
INTERROG_PRON+CASE_INDEF_GEN	WP	WP	
IV3MP+IV_PASS+IVSUFF_SUBJ:MP_MOOD:SJ	VBNMP3+SMP	VBNMP+SMP
IV2FS+IV_PASS+IVSUFF_MOOD:I	VBNFS2+S	VBNFS+S
PV_PASS+PVSUFF_SUBJ:3MD	VBN+SMD3	VBN+SMD
IV3MD+IV_PASS+IVSUFF_SUBJ:D_MOOD:SJ	VBNMD3+SD	VBNMD+SD
POSS_PRON_3MS	PRP$MS3	PRP$MS
POSS_PRON_3D	PRP$D3	PRP$D
PRON_3D	PRPP3	PRPP
ADJ_COMP+CASE_DEF_GEN	JJR	JJR
NOUN_NUM+NSUFF_MASC_PL_ACCGEN	CDMP	CDMP
ADJ_COMP+NSUFF_MASC_PL_NOM	JJRMP	JJRMP
NOUN_PROP+NSUFF_MASC_PL_NOM	NNPSMP	NNPSMP
NOUN_PROP+NSUFF_FEM_DU_NOM	NNPSFD	NNPSFD
NOUN.VN+NSUFF_MASC_DU_NOM	VBGMD	VBGMD
ADJ_NUM+NSUFF_FEM_SG+CASE_DEF_GEN	ADJNUMFS	ADJNUMFS
ADJ+NSUFF_FEM_DU_NOM	JJFD	JJFD
ADJ+NSUFF_MASC_PL_GEN	JJMP	JJMP
IV2FS+IV+IVSUFF_SUBJ:2FS_MOOD:I	VBPFS2+SFS2	VBPFS+SFS
NOUN_NUM+CASE_INDEF_GEN	CD	CD
IV3MS+IV+IVSUFF_MOOD:I	VBPMS3+S	VBPMS+S
NOUN_PROP+CASE_DEF_ACC	NNP	NNP
RESTRIC_PART	RP	RP
JUS+IV3MP+IV+IVSUFF_SUBJ:MP_MOOD:SJ	VBPMP3+SMP	VBPMP+SMP
IV2FS+IV_PASS+IVSUFF_MOOD:S	VBNFS2+S	VBNFS+S
IV3FS+IV_PASS	VBNFS3+S	VBNFS+S
NOUN+NSUFF_FEM_PL+CASE_DEF_GEN	NNSFP	NNSFP
INTERROG_PRON+CASE_DEF_GEN	WP	WP
EXCLAM_PRON	WP	WP
NOUN_QUANT+CASE_INDEF_NOM	NOUNQUANT	NOUNQUANT
ADJ_COMP+CASE_DEF_NOM	JJR	JJR
NOUN_NUM+NSUFF_FEM_SG+CASE_DEF_NOM	CDFS	CDFS
ADJ_NUM+CASE_DEF_ACC	ADJNUM	ADJNUM
ADJ_NUM+NSUFF_FEM_SG+CASE_INDEF_NOM	ADJNUMFS	ADJNUMFS
NOUN.VN+NSUFF_FEM_SG+CASE_DEF_GEN	VBGFS	VBGFS
NOUN_NUM+NSUFF_FEM_PL+CASE_INDEF_NOM	CDFP	CDFP
NOUN_NUM+NSUFF_FEM_PL+CASE_INDEF_GEN	CDFP	CDFP
NOUN_NUM+NSUFF_FEM_PL+CASE_INDEF_ACC	CDFP	CDFP
IVSUFF_DO:3MS	PRPMS3	PRPMS
NOUN.VN+NSUFF_MASC_PL_GEN	VBGMP	VBGMP
IV2MP+IV+IVSUFF_SUBJ:MP_MOOD:SJ	VBPMP2+SMP	VBPMP+SMP
DEM_PRON_MD	DTMD	DTMD
NOUN_NUM+NSUFF_FEM_DU_GEN_POSS	CDFD	CDFD
NOUN_NUM+NSUFF_FEM_DU_NOM	CDFD	CDFD
IV2MS+IV+IVSUFF_MOOD:I	VBPMS2+S	VBPMS+S
CVSUFF_DO:1S	PRPS1	PRPS
FUT+IV3MS+IV+IVSUFF_MOOD:I	VBPMS3+S	VBPMS+S
REL_PRON+CASE_DEF_NOM	WP	WP
INTERROG_ADV	WRB	WRB
ADJ+CASE_DEF_GEN	JJ	JJ
ADJ_NUM+NSUFF_FEM_PL+CASE_DEF_NOM	ADJNUMFP	ADJNUMFP
PSEUDO_VERB	VBP+S	VBP+S
ADJ_NUM+NSUFF_MASC_PL_ACCGEN	ADJNUMMP	ADJNUMMP
ADJ_NUM+NSUFF_MASC_PL_ACC	ADJNUMMP	ADJNUMMP
ADJ+NSUFF_FEM_PL+CASE_INDEF_ACC	JJFP	JJFP
FUT+IV3MS+IV_PASS+IVSUFF_MOOD:I	VBNMS3+S	VBNMS+S
NOUN+CASE_DEF_ACC	NN	NN
REL_PRON+CASE_INDEF_ACC	WP	WP
ADJ_NUM+NSUFF_MASC_DU_GEN	ADJNUMMD	ADJNUMMD
NOUN_NUM+CASE_DEF_ACC	CD	CD
DIALECT	NN	NN
IVSUFF_DO:3FS	PRPFS3	PRPFS
FUT+IV3MD+IV_PASS+IVSUFF_SUBJ:D_MOOD:I	VBNMD3+SD	VBNMD+SD
NOUN.VN+NSUFF_FEM_SG+CASE_INDEF_GEN	VBGFS	VBGFS
INTERROG_PRON+NSUFF_FEM_SG+CASE_DEF_GEN	WPFS	WPFS
IV1P+IV+IVSUFF_MOOD:I	VBPP1+S	VBPP+S
IV3MD+IV_PASS+IVSUFF_SUBJ:D_MOOD:I	VBNMD3+SD	VBNMD+SD
NOUN_PROP+NSUFF_FEM_PL	NNPSFP	NNPSFP
NOUN_NUM+NSUFF_FEM_DU_GEN	CDFD	CDFD
ADJ+NSUFF_FEM_SG	JJFS	JJFS
PV_PASS+PVSUFF_SUBJ:3FS	VBN+SFS3	VBN+SFS
POSS_PRON_3FP	PRP$FP3	PRP$FP
IV1S+IV+IVSUFF_MOOD:I	VBPS1+S	VBPS+S
ADJ.VN+NSUFF_MASC_PL_GEN	VNMP	VNMP
NOUN_PROP+CASE_DEF_NOM	NNP	NNP
NOUN_QUANT	NOUNQUANT	NOUNQUANT
ADJ	JJ	JJ
NOUN_NUM+NSUFF_MASC_DU_GEN_POSS	CDMD	CDMD
PV_PASS+PVSUFF_SUBJ:3FP	VBN+SFP3	VBN+SFP
PV+PVSUFF_SUBJ:2MP	VBD+SMP2	VBD+SMP
IV3FD+IV+IVSUFF_SUBJ:D_MOOD:SJ	VBPFD3+SD	VBPFD+SD
PVSUFF_DO:1S	PRPS1	PRPS
NOUN.VN+CASE_INDEF_ACC	VBG	VBG
NOUN+NSUFF_MASC_DU_ACCGEN_POSS	NNSMD	NNSMD
IV3MD+IV+IVSUFF_SUBJ:D_MOOD:SJ	VBPMD3+SD	VBPMD+SD
PRON_3FS	PRPFP3	PRPFP
ADJ+CASE_INDEF_NOM	JJ	JJ
CVSUFF_DO:3MP	PRPMP3	PRPMP
IV2MS+IV_PASS+IVSUFF_MOOD:J	VBNMS2+S	VBNMS+S
NOUN+NSUFF_FEM_SG+CASE_INDEF_ACC	NNFS	NNFS
PV_PASS+PVSUFF_SUBJ:3MP	VBN+SMP3	VBN+SMP
IV3MS+IV+IVSUFF_MOOD:S	VBPMS3+S	VBPMS+S
IV3MD+IV+IVSUFF_SUBJ:D_MOOD:I	VBPMD3+SD	VBPMD+SD
NOUN.VN+NSUFF_FEM_PL+CASE_DEF_ACC	VBGFP	VBGFP
CVSUFF_DO:3MS	PRPMS3	PRPMS
NOUN+NSUFF_FEM_DU_ACC_POSS	NNSFD	NNSFD
NOUN+CASE_DEF_NOM	NN	NN
NOUN_QUANT+NSUFF_MASC_DU_ACC_POSS	NOUNQUANTMD	NOUNQUANTMD
ADJ.VN+NSUFF_FEM_SG+CASE_DEF_NOM	VNFS	VNFS
NOUN_NUM+CASE_INDEF_NOM	CD	CD
PV+PVSUFF_SUBJ:3FD	VBD+SFD3	VBD+SFD
ADV+CASE_INDEF_ACC	RB	RB
ADJ.VN+NSUFF_FEM_SG+CASE_INDEF_ACC	VNFS	VNFS
NOUN_PROP+NSUFF_FEM_SG	NNPFS	NNPFS
IV3FD+IV+IVSUFF_SUBJ:D_MOOD:I	VBPFD3+SD	VBPFD+SD
NOUN_PROP+NSUFF_FEM_SG+CASE_DEF_ACC	NNPFS	NNPFS
ADJ.VN+NSUFF_MASC_DU_ACC	VNMD	VNMD
FUT+IV2MS+IV+IVSUFF_MOOD:I	VBPMS2+S	VBPMS+S
REL_PRON+NSUFF_MASC_SG_ACC_INDEF	WPMS	WPMS
ADJ.VN	VN	VN
IV3FS+IV+IVSUFF_MOOD:I	VBPFS3+S	VBPFS+S
PV+PVSUFF_SUBJ:2MS	VBD+SMS2	VBD+SMS
NEG_PART	RP	RP
IV3MS+IV+IVSUFF_MOOD:J	VBPMS3+S	VBPMS+S
NOUN_NUM+NSUFF_MASC_DU_NOM	CDMD	CDMD
NOUN_NUM	CD	CD
NOUN_QUANT+NSUFF_MASC_DU_NOM_POSS	NOUNQUANTMD	NOUNQUANTMD
FUT+IV3FS+IV+IVSUFF_MOOD:I	VBPFS3+S	VBPFS+S
IV2FS+IV+IVSUFF_SUBJ:2FS_MOOD:SJ	VBPFS2+SFS2	VBPFS+SFS
NOUN.VN+NSUFF_MASC_PL_NOM	VBGMP	VBGMP
ADJ+NSUFF_FEM_PL+CASE_DEF_NOM	JJFP	JJFP
IV3FS+IV_PASS+IVSUFF_MOOD:S	VBNFS3+S	VBNFS+S
ADJ+NSUFF_MASC_PL_ACC	JJMP	JJMP
DEM_PRON_FS	DTFS	DTFS
REL_ADV	WRB	WRB
NOUN_NUM+NSUFF_MASC_PL_ACC_POSS	CDMP	CDMP
REL_PRON	WP	WP
PRON_1P	PRPP1	PRPP
IV3MS+IV_PASS	VBNMS3+S	VBNMS+S
IV3MP+IV_PASS+IVSUFF_SUBJ:MP_MOOD:I	VBNMP3+SMP	VBNMP+SMP
NOUN_NUM+NSUFF_FEM_SG+CASE_INDEF_ACC	CDFS	CDFS
JUS+IV3FS+IV+IVSUFF_MOOD:J	VBPFS3+S	VBPFS+S
PVSUFF_DO:3D	PRPD3	PRPD
NOUN.VN+NSUFF_FEM_SG+CASE_DEF_NOM	VBGFS	VBGFS