ميتين ام الناموس على اللى متعاطف معاه #ارحل	NEG
1981 الله ينور عليك يا أحمد مقالين أروع من بعض المجد للكتابة الحلوة	POS
وطبعا محدش سمع من مصاب فقد عينه الإثنين أو حصله عجز من يوم 28 يناير 2011 #جمعة_الغضب أن الناس بتقوله خربتوا البلد وهو كل اللي قاله #حرية !!	NEUTRAL
يعنى مش عارف بياكلوا الظباط خرا عشان يجى لهم قلب يكهربوا طفل فى سنة سادسه ابتدائى ولا ايه #باسم	NEG
ترقصين بعرس واطالعين فوق وتحركين حلجج يعني حافظه الاغنيه:)؟ #لازم طلقه بالراس:)	NEUTRAL
لكن في أرض النفاق كالعادة يكسب الكداب #كايروكي	NEG
الوعود المتكررة بانتخابات حرة نزيهة فى غياب الضمانات البديهية لنزاهتها هى مجرد كلام اجوف كفانا خداعا للشعب	NEG
#أحبك_ربي الحمد لله	POS
الله يسامحه #حسني_مبارك اكبر غلطة عملها فينا كشعب هو كمية الجهل الرهيب اللي اتسبب فيه!!	NEG
على سبيل #السعاده انا صديق مجدى	POS
عمرو عبد الهادى : المواطنين الشرفاء بتوع #الداخليه زي المحامين الشرفاء بتوع #سامح_عاشور و زي اﻻعلاميين الشرفاء بتوع #نجيب_ساويرس	NEUTRAL
بالفيديو #توفيق_عكاشة : هيفاء "ولية ناشفة محشية طوب" وهترشح للبرلمان بسببها	NEG
بصرف النظر عن الموضوع ده تحديدا مش مهم رأي النخبة المهم كلنا نسمع الشارع كويس #مصر	NEUTRAL
هالايام تمر علي مواقف قديمة لكن مع أشخاص جدد #احساس_غريب	NEUTRAL
#هذي_مصر العمود الفقري للوطن العربي	POS
جابر نصار رئيس جامعة القاهرة انقلابي عايش فى بلد تانية غير مصر يقول: الوزير مايقدرش يطرده لأنه منتخب هو مرسي	NEG
هو الاحتلال عبارة عن ايه؟ دبابات طيارات مجنزرات اعتقالات حظر طوارئ قتلإلخ تبقى ثورة دي ولا احتلال؟؟ احتلال ا…	NEUTRAL
أيها المتطرف في أي مكان في العالم اسحل المسلمين كما تشاء وإن لامك أحد فقل له هل يرضيك ماحدث للشيعة والبهائيين والمسيحيين في مصرقانون الغابة	NEG
ليه مستكترين إن الست تنفيطيب شكرا ليها إنها نفت كلام طائفي زي دهولازم يتم عمل تحقيقات قضائية لإثبات وجود قرصنة ولو طلع كدب ساعتها تتحاسب	NEUTRAL
مصر عمرها ما كانت هيبة في عهد مبارك ده كلام رخيص مصر كانت هيبة في ال18 يوم هيبة بجد والعالم كله وقف يتعلم وده كان الشعب	NEUTRAL
ألم يحين الوقت لعمل فيلم عن العملاق إبراهيم الرفاعي؟	POS
علامة الصرصار بدون تفويض ، تمكن السيسى من قتل 230 شهيد وإصابة 896 ، واغلاق عدد من الفضائيات والصحف واعتقال	NEG
انتهوا من سجن كل قيادات المعارضة وتحولوا الى أبنائهم وبناتهم وزوجاتهم مصر لم ولن تشهد قمعا وشيطانية كما نرى من عصابة الانقلاب	NEG
خالد و البسطويسي و وابو العز مرشحو الثورة شخصيات وطنية عظيمة اتمنى ان يتوحدوا خلف حمدين لانه في رأيي الأقدر والأقرب للفوز	NEUTRAL
#ذكرى وأحلى ذكرى أول واقفة فى #التالتة_شمال #07 #الأهلي	POS
هو ما ينفعش حد ييجي ويمشي عدل أبداً ده إيه القرف ده	NEG
اقدر التشويش الشديد الذي يمر به المصريون جميعا انا لم انتخب مرسي ومقالي موجود لكنى أتفهم موقف من انتخبوه حتى لا ينجح شفيق الذي هو مبارك	NEUTRAL
وجاء مرسي وخطب في الناس بدون حماية ،منظر رائع، شئ يدعو للفخر،ثم ظهر صفوت حجازي اللعنة	NEUTRAL
كانوا أقزاما مع ناصر والسادات ومبارك وطنطاوى والان يقولون الا السيسي الخسيسي يفضل طول عمره خسيسي	NEUTRAL
يعني لما أقول إن مبارك المخلوع سحب سفيرنا من إسرائيل مرتين قبل كده يوصل اللغط أن النعاج والخرفان يقولوا أني بشكر فيه؟ فعلاً بكل طلاقة #ماء	NEG
الرابط اللي بيقول أني صورت حلقة مع رامز جلال غير صحيح ده فيروس على الفيس بوك رجاء الحذر	NEG
جمال سلطان فضح الانقلاب واعاد الحق لمرسي بعد ان عانده كثيرا	NEUTRAL
الشعب ما نزلش علشان تحصل فتنة طائفية غريبة ان امريكا مش بتتكلم عن اضطهاد الأقباط في …	NEUTRAL
#بلال_فضل مفتقد مقالاتك جدا	POS
قرار كويس وهايل و مستنيينه من زمانلكن #السادة_المحترمون	POS
حين يكافئ من تفوه بعبارات كراهية وعنصرية ضد المسيحيين بتعيينه في لجنة الدستور و حين يخرج من مزق الانجيل بكفالة فلا تندهش مما يحدث الان	NEG
المحنة اخرها فرحة #الاهلي_الافريقي	NEUTRAL
صباح حنون وهادى بصوت #ماهر زين على كل فولورى الحلوين :) #سمكة_بتصبح ☺	POS
ثقافة القطيع وحشة جدا زي موضوع تشومسكي اللي جريوا كلهم وراه وطلع متفبرك في الآخر بنص كلام تشومسكي	NEG
2050 لا يا سيدي كنت موجود وهذا أكبر دليل أن هؤلاء المسلحين من داعمي الإخوان اللي كفرونا وهاجمونا في كل مكان ساعتها	NEG
جزاك الله عنا خيراً يا رسول الله #الحبيب	POS
#سلامتك_يا_خليفة إن من حق ولي الأمر علينا جميعا أن ندعوا له بظهر الغيب بالشفاء العاجل اللهم ألبس الشيخ خليفة ثوب الصحة ولباس العافية	POS
يوم جديد وجمعه مباركة لتخليص مصر من الانقلاب وحكم العسكر عشان الى يحكمنا يعرف ربنا ومش لازم يجذب الستات	NEUTRAL
لا حدود لانحطاط أولئك الذين يروّجون أن أهل غزة يريدون احتلال سيناء أي نوع من الأحذية في جماجمكم وجماجم من يصدّقكم؟	NEG
ليت كل مسيحيين مصر زيك #اللى_رافضين_السيسى_رئيس_بيعملوا_فولوا_لبعض #انتخبوا_العرص #مرسى_رئيسى #سيناء_خارج_التغطية …	NEUTRAL
الحيوان من يتجرد من أنسانيته ويبرر قتلهم لمجرد أختلافه معهم #رابعه_العدويه يا حيواااااان شغل مخك	NEG
لما #عدلى_منصور يصدر قانون لحماية وتشجيع #الاستثمار ويجى واحد #جاهل من #الثوار يقول أن #عدلى_منصور بيهدر المال العام يبقى احنا فى زمن #المسخ	NEG
أقول للشتامين مشكلتكم ليست مع الكتاب والإعلاميين بل مع جيل ثائر خذلتموه وخنتموه ثم أصبحتم تحملون دمهوأختم كلامي بقول المرشد ماذنب النباتات؟	NEG
يقصر بعض الناس سراويلهم لانه نوع من الخيلاء و اذا به ينزل من عربية مرسيدس #عبث	NEG
أتقدم بخالص التهنئة إلى الإخوة الأقباط بمناسبة عيد الميلاد المجيد أعاده الله على مصر بالأمن والرخاء	POS
": فيديو: الإخوان #كاذبون_بسم_الدين "	NEG
#جلال_عامر الغائب الحاضر	POS
باقي على #رمضان 69 يوما تقريباً وتبدا القصه الجميله وتعلو المساجد بأصوات التراويح اللهم بلغنا رمضان لا فاقدين ولا مفقودين ♡"	POS
"أمين شرطة يتحرش يراكبة اجنبية بالمطار وزملاؤه يعتصمون اعتراضا على نقله "| #مرار_طافح …	NEG
فلتقل خيرا أو لتصمت #خلق_جميل	POS
قسما بربي لو رأيتك أمامي لجعلتك جثه هامده تأكل منها الكلاب	NEG
الطريق الى جماعة الاخوان المسلمين الارهابية #الاخوان_جماعة_ارهابية	NEG
"_97: ههههه عادي مالها ال14 سنه :)" أجدع ناس و فخور جداً بيكم	POS
الدرس المستفاد: لا تظن أن كل الناس خرفان يصدقون ما تقوله لمجرد أنه جاء على لسانك، فلديهم كيبوردات يستخدمونها في البحث وعقول للنقد والتفكير	NEUTRAL
شعب يعشق العبودية #اللى_رافضين_السيسى_رئيس_بيعملوا_فولوا_لبعض	NEG
#حازم_عبد_العظيم العرص يكشف لماذا تحول من صفوف #الثوار لصفوف #الانقلاب	NEG
#سؤال_برئ كل الناس يوم الجمعه تنزل صور وتكتب #جمعه_مباركه وكده هيا باقى الايام #نجسه يعني ولا ايه؟	NEUTRAL
#فتاوي الدياثة #البرهامي #الهلالي #الاحداث المفتعلة #سما #مرتضي #باسم #نمر في سيرك #الالهاء لتمرير جرائم كبري #انعدام الخيال #ابهار	NEG
شكرا على مشاعرك الطيبة	POS
إغلاق حسابين على تويتر ينشران فضائح الفساد بسبب #أردوغان #الاخوان_جماعة_ارهابية #تركيا #قمع	NEG
رضا عبدالسلام: كلام دعبدالمنعم أبوالفتوح الاقرب إلى الناس وهو علامة من علامات مصر هو شخصية مصرية مضحية حتى النخاع	POS
#ﺣﻤﺪﻳﻦ_ﻋﺎﻭﺯ_ﻳﺤﺎﻛﻢ_ﺍﺳﺪ_ﺍﻟﻌﺮﺏ برضو #سأنتخب_السيسى_و_مش_هنزل_لمستواك	NEUTRAL
انت مش مضطر تتجوز بالطريقة البضان دي انت بني ادم سواء كنت اجتماعي او انطوائي صدقني دي اسوأ طريقة ممكن تتجوز بيها #جواز_…	NEG
مش متخيل أن ف حد ممكن يدعي ع ابوه او امه مهما كانوا خنقيين او عصبيين بس لﻷسف في #بر_الوالدين ياوﻻد الجزمه	NEG
وزير الغلابة #باسم_عودة معتقل ف سجون العسكر ل #افضل_منتج_لاكرم_شعب #انا_مش_رقم #انتفاضة_السجون	POS
علاء الاسواني: رأيي أننا متحضرون لكننا نعيش في دولة غير متحضرة أقرأ المقال كامل	NEUTRAL
الفائزون عالميا وافريقيا من انصار رابعة والشرعية والفاشلون انصار الانقلاب يا وزير للرياضة يا خسران بالستة يا	NEUTRAL
افتخر بلغتي 😍😍 #اليوم_العالمي_للغة_العربية	POS
ناس كتير قاعدة على #تويتر تحس إنها ناس فاضية بتهري و خلاص #مرار_طافح	NEG
بلغني اليوم أن شركة مصر للطيران رفضت عرض فيلم الشتا اللي فات على متن طائراتها وذلك لأنه يتحدث عن الثورة لو لم يكن من أبلغني أخطأ فهذا عار	NEG
#ﺍﻟﺸﻌﺐ_ﻳﺮﺩ_تحية_الرئيس #انتخبوا_العرص #خليك_مصدق حمو ثورة 25 يناير وانهم مافتحوش الميدان يوم الجمل	NEG
منذ غرس بذرتها الشهيد #حسن_البنا ليسقيها بدمه صاحب الظلال ليتم الفتك ببطل أول صندوق إنتخابي ديموقراطي وشعبية #الاخوان_…	POS
انا مصرى و #ضد_الفحم #أوقفوا_الفحم #فحم_لية لمصلحة مين يتم استخدام الفحم طبعا لمصلحة اصحاب #مصانع_الاسمنت	NEG
أثق تماما ان محاكم التفتيش الإخوانية لن ترهب باسم يوسفانتظر الرد على فاشية الاخوان في الحلقة القادمة المبدع أقوى بكثير من الرئيس المرؤوس	NEUTRAL
" مسيرة جت من #التحرير في #طلعت_حرب وصلوا ميدان طلعت حرب وبيهتفوا بحماس جديد يا غراب يا معشش #انشكاح	POS
جماعة الإخوان الإرهابيون بقئلهم سنتين و نصف سبب الكآبة و الحزن لكل المصريين إنتظروا رد الشعب - جنازة الشهداء …	NEG
ومن أراد حكم الأهطل ربنا يتولاه	NEG
قوات الأمن المصرية تقوم بضبط "لاب توب" يحوي أغاني مسيئة لـ"السيسي" هذه ليست نكتةهذه حادثة حقيقية في مصر بعد …	NEG
امل محمود فى ذمة اللهرحلة عطاء ومقاومة باسلة ستبقى فخرا لجيلنااالهم اجزها خيرا عنا وبواسع رحمتك ادخلها واسع جنتك	POS
انك عربي و صاحب قضية #اوعى_تنسى	NEUTRAL
ﻷنك انت كل حياتي مهما بالدنيا يصير ♡ #كلمة_حلوة"	POS
اذن فلتحرقنا الحرب جميعا حظ سعيد في محاولة ابادة او اخضاع مئات الالاف	NEUTRAL
إحنا مايفرقش معانا هو موافق ولا لأ إحنا عايزين حنان ليس إلا	NEUTRAL
أدين بكل قوة العنف بكافة أشكاله وصوره ضد كل إنسان أيا كانت عقيدته أو انتماؤه قوتنا هي الحق وسلميتنا هي السبيل	NEG
الشتا اللي فات "فيلم عظيم" برافو	POS
يوسف الحسيني يفضح كذب قناة الجزيرة ويكشف تمثيل الاخوان "	NEG
متفق مع جوانب بمقال أحمد خالد توفيق وأعتقد أن التحفز ضد الحاكم دون فبركة أو كذب هو أمر مهم في بلد تعشق صناعة الفرعون	NEUTRAL
القراء الأعزاء اعترافا مني بأننا معشر الصحفيين عالم ولاد تيت (الا من رحم ربي) وأننا احيانا نلجأ لكتابة …	NEUTRAL
بعد قراءة مادة 219 الصوفيين يعملوا إيه كده؟ ليه نقفلها ع "السنة والجماعة"؟ ولا دي تمهيد للحرب مع الشيعة؟ دستور مريب ليس للمصريين	NEG
على الـ الان محمد سامي يقول : الحكم على 700 انسان بالاعدام أمر مبهج !! اين وصلت الانسانية !! #مصر #القاهرة #الاخوان #الفلول	NEUTRAL
ازاي؟ على تويتر؟ لقينا حزب عدل وقلنا يع؟ لما يبقى ليك جبهة قوية ماشي غير كده تتفاوض	NEUTRAL
الى الشيخ احمد الطيب انا مسلم سنى وانت لا تمثلنى احترم الازهر لكننى احتقرك جدا	NEUTRAL
اسمي ميشيل وانا سكرتير دعلاء وبأنقله تويتات المديح والتأييد والنقد العنيفاما الشتائم المبعوتة من الفلول او المتطرفين بارميها في الزبالة	NEUTRAL
المطرب الوقح بيشتمنا ويغنى: لما امريكا تؤمر يردوا يقولوا امين واحنا بنقولو لما وقح يغنى لامثاله يقولو: امين	NEG
اشعر بالألم الشديد و نحن نعيش فوضى لا أخلاقية و انحطاط في المبادئ و القيم و صدمة ممن كنا نعتقد أنهم بصدق علماء و دعاة	NEG
صاحب قناة الفراعين للمصري اليوم: "أنا ملك التوك شو" خبر صحيح و وصف دقيق طيب الله أوقاتكم	POS
من اتهموا الاخوان بالفاشية الإسلامية استقدموا علماء الدين لإقناع الجنود بقتل إخوانهم المصريين من المتظاهرين	NEUTRAL
لا لازدواجية المعايير عند نبذ العنف، لا لتبرير العنف بالسياسة أو أهدافها أو اختلافاتها، لا للإقتتال الأهلي عبر دوائر العنف والعنف المضاد	NEG
": يضاف اليهم البرادعى ضمير الثورة" طبعا	POS
اى والله :) #اسلوب_حياة	POS
#يوسف_الحسيني امريكا لاتعنيها سوريا ولا الشعب السورى ولا نصره الاسلام، لكن يعنيها الكيان الصهيوني وحماية تركيا	NEUTRAL
3 غير صحيح! التوقيع لخالد كان لتمكينه وهو الشاب الوحيد والأكثر جراءة في الدفاع عن المدنية من دخول السباق الرئاسي	POS
عودة لسجون مبارك	NEG
ياخى الفجيكات دول يتحبوا من غير مقدمات كده :) #نوبة	POS
فقط مد اليد والدمج في إطار القانون والسلمية والامتناع عن التوظيف الزائف للدين هي المضامين التي ستمكننا من الدعوة إلى مصالحة وطنية حقيقية	NEUTRAL
وحرامية بلدنا طلقاء يحكموا بلدنا النزيه#باسم_عودة فك الله اسرك انت وكل احرار بلدنا	NEG
أحضر المؤتمر العام للمصريين الأحرار فخور و سعيد و شعلة الأمل	POS
اللهم بلغنا رمضاااااااااان #نفسي يرجع بقا	POS
و انت مالك	NEG
رموا على جمعه وجابو خالد الجندى الاحتفالات الدينية حرام على مرسي حلال للجيش	NEUTRAL
#اعرفوهم #انقلاب_مصر #يسقط_حكم_العسكر #الداخلية_بلطجية #الحرية لمحمد شعبان عبدالقوي 18سنة طالب بكلية العلوم #المنوفية	NEG
قبل كده وبعدما قفلوا النت في البترول كنا نرسل اللنك لسيرفرات برة وهم الله يجزاهم خير يرسلوا الصفحة، ونستمر على كده #تخيل	NEG
المبادرة جميلة كلفتة من العمل المجتمعي لكن ماذا بعد؟هل سننزل للقبض على المجرمين لان #الشرطة متخاذلة	NEG
اللهم امطر على قبر #محمد حسين جمعه وعلى قبور جميع موتانا وموتى المسلمين من سحائب رحمتك يارب اللهم اغسلهم بالماء والثلج والبرد	POS
_ يااااااه يا مالك بترد على حالة مر عليها 31 يوم؟! :) حالة الانقسام التي شهدتها القوى الديموقراطية هي التي أدت لذلك	NEG
تطهير الداخلية الآن وفورا	NEG
في مذيعة بتزغرت على الهوا #الام_المثالية	NEG
الحمد لله والله أكبر التحية للشعب المصرى العظيم القائد والمعلم دائما وأبدا التحية للقوات المسلحة النصر للثورة والمجد للشهداء	POS
انا مستعد للقيام بأي دور لخدمة الوطن حفاظا على التضحية التى قدمها الشهداء وحماية لمطالب الثورة	POS
إتفرج ياسلام صلاح جاهين ومحمود السعدني في بروجرام واحدرحم الله الجميع وجزاهم عنا وعن مصر خير الجزاء	POS
اشارككم قلقكم من حالة الاستقطاب السائدة في الحياة السياسية الآن وقد طالبت بعودة التوافق الوطني بين كل التيارات	NEG
9سبتمبر عيد الفلاح الذى ظلمته السلطة واهملته المعارضة نحتاج لاصلاح زراعى جديد و نقابة مستقلة للفلاحين لا تغيير بدون الجماهير وفى قلبها الفلاحين	NEG
أياكس يسعى لخطف الموهبة المغربية الأصل "مستور "من معقل ميلان #ميلان #اياكس	NEG
إِيّاكَ نَعبُدُ وَإِيّاكَ نَستَعينُ	POS
د عبد المنعم أبو الفتوح: أبعث بتهنئتى وتحياتي الى شباب الثورة الذي مازال يدافع من أجل استمرار مسيرة الثورة	POS
"هذا يتنافى/يختلف مع كل القواعد التى تعلمناها"جملة تكرس الجمود وعدم التطور فلولا هذا ا ختلاف والتنافي لمكثنا في عصورالظلام #مصر #تونس	NEUTRAL
ما يتحدث عنه المجلس العسكري من تفعيل لحالة الطوارئ مرفوض شكلا وموضوعا	NEG
هل الحروب الصليبية التى ارتكبت ابشع الجرائم باسم المسيحية تجعلنا نعادى كل المسيحيين في العالم أنا اعادى الأفعال السيئة ولا أعادى الديانات	NEG
لن تحقق الثورة أهدافها بصفقات مع القتلة	NEG
سيدي الفاضل اعلم جيدا ان #دحلان_عميل و #ضاحي_خلفان إنما هم كلاب ضالة أطلقها أسيادهم	NEG
إعلان الدم الدستورى بمجرد أن انتهت قوات الجيش والشرطة من مذبحة الحرس الجمهورى	NEG
هل تعرف معنى اسم الله الصمد ؟ "الصمد" الذى يُقصد إليه فى قضاء الحوائج "الصمد" لا يحتاج إلى أحد و يحتاجه كلُ أحد	POS
حبيتلكن حب من غير حنان وصحبتلكن صحبة من مالهاش أمان رحت لحكيم واكتر ولقيت بلوتى ان اللى جوه القلب مش ع اللسان ًعجبى #صلاح_جاهين	POS
القائمة الأولى للخونة الذين خدعوني بتعريف كلمة مبقوق :)	NEG
الثورة مكملة #ثورة_25_يناير #باسم_رئيسا_لمصر #انتخبوا_العرص	NEG
#إبراهيم_محلب هايدخل التاريخ وهايحل مشكلة سد النهضة وإبقو إفتكرو إن مدرستى#دى_لاسال قدمت هدية لمصر من أحد خريجيها الناجحين	POS
و #السيسي حارب #الارهاب عشان كده بتحصل تفجيرات , حسبنا الله ونعم الوكيل	NEG
هي #سما_المصري تتحسب مع البني ادمين ولا ايه النظام ؟ -_- #ارف	NEG
الدائرة غير متجانسة و لايمكن السيطرة عليها من عصبية او اقلية او من اتجاة سياسي	NEUTRAL
سامي الجابر يتحمل كل شيء لأنه اعطي الصلاحية كاملة،مين يختار اللعيبة والتشكيلة ومين يضع التكتيك "اذا كان فيه تكتيك	NEG
عملاء يكرهون الجيش المصري#عبدالرحمن_يوسف #انتخبوا_العرص #مصر_العربية #الإخوان #بلاش_شتيمة	NEUTRAL
كيزاد أفضل منصة لتأسيس الأعمال في المنطقة  #الإمارات #بالعربي	POS
عبدالناصر الخائن الاكبر #الاخوان_المسلمون	NEG
ﺍﻟﺠﻴﻮﺵ ﺍﻟﻌﺮﺑﻴﺔ ﺃﻛﺬﻭﺑﺔ ﻛﺒﻴﺮﺓ ﻓﻘﺪ ﻛﺎﻧﺖ ﺃﻭﻝ ﺣﺮﺏ ﺧﺎﺿﻬﺎ ﺍﻟﺠﻨﺮﺍﻝ العسكري الكبير عبدالفتاح ﺍﻟﺴﻴﺴﻲ ﻓﻲ ﺣﻴﺎﺗﻪ ﻫﻲ ﺣﺮﺏ ﺭﺍﺑﻌﺔ ﺍﻟﻌﺪوية	NEG
اسألوا #البرادعي عما فعله في #العراق #البرادعى_طلع_جاسوس #باسم_طلع_حرامي #تخابر	NEG
عظيم نجاح أجهزة الدولة وبالتعاون مع أهل سيناء في إطلاق سراح الجنود المختطفين دون إراقة للدماء، هذه إدارة أزمة ناجحة ينبغي الإشادة بها	POS
''وما النصر اﻻ من عند الله''	POS
#الاخوان_جماعة_ارهابية يجب التضييق على اخوان الخليج فهم اذناب للتنظيم الدولي للاخوان ولا يقلون خطوره عن اخوان مصر	NEG
اختيارلجنة المائة يجب أن يتم وفق معايير واضحة تراعي تمثيل كافة قطاعات المجتمع من رجال نساء عمال فلاحين مسلمين مسيحين وأهلنا في سيناء والنوبة	NEUTRAL
أجور العمال في شركات الأسمنت أقل من تكلفة ورق شكائر الأسمنت #أوقفوا_الفحم	NEG
"واضح ان الترمادول ملا البلد: #الببلاوي: تولِّى #السيسي رئاسة مصر معناه انتهاء الحكم العسكري "	NEG
ما هي صفة مكتب الارشاد ليجتمع لبحث حكم المحكمة الدستورية، هو مرسي واخد بكرة مرضي؟	NEG
أمراض السياسة حين تؤلم شخصيا	NEG
اللهم احرسني بعينك التي لا تنام، واكْنُفْني بركنك الذي لا يُرام، لا أهْلِكُ وأنت رجائي، رب ! كم من نعمة أنعمت بها	POS
لا تثقل يومك بهموم غدك فقد لا تأتى هموم الغد و تكون قد حرمت نفسك من سرور يومك صباحكم سعادة و سرور :)	NEUTRAL
اطاح الاستفتاء بمبدأ تكافؤ الفرص حينما لم يسمح بالتصويت لكل المقيمين بالخارج الا من قام بالتسجيل في الانتخابات	NEUTRAL
اللى حصل مع محمود شعبان فى التحرير أفترا عليه لأنه ضعيف	NEG
براءة مبارك في قتل المتظاهرين كانت في جلسة 15 أبريل 2013 يعني في عز حكم الإخوان ولم يتم الإستئناف	NEUTRAL
تَحَدَثوآ عَن أيْ شَيء ~ — #المدارس بالمجموع #والكليات بالواسطة #والجواز بالفلوس # والصحوبية بالمصلحة #	NEG
اول مرة أشوف مناظرة بدون مقاطعة ولا صراخ وكل طرف واخد وقته في الكلام،أحيي #يوسف_الحسيني لإدارة الحوار بهذا الرقي	POS
التعادل فى نهاية اللقاء قلل فرحة الاهلى لكنه خير لأنه سيجعل لقاء الاياب فى القاهرة حاسما ودور المصريين خلاله حاسم لاعلاء اسم بلدهم وفريقهم	NEUTRAL
منع برنامج الاراجوز باسم يوسف والقضاء اغلق كل القنوات المحترمة قتلوا حرية الرأى والاعلام وحرقوها	NEG
تحية لجميع النساء في #يوم_المرأة_العالمي نحتفي بالمرأة كل يوم أماً وبنتاً وأختاً ورفيقة درب وحياة وصانعة أمم	POS
لا يجوز للسلطة التنفيذية ان تتدخل لمصادرة اي منتج ابداعي فيلما او كتابا او ايا كان نحن في حاجه للمبدعين	NEG
انك تدافع عن اي بنت لو لاقيت حد بيدايقها ف الشارع , الرجوله دي #خلق_جميل	POS
#طارق_الزمر: فتاوى #برهامي تروج لاغتصاب الأمة أو السلطة	NEG
هذا إن أشار أو وشى، فإنما يشي بإنه مفيش أي قيمة وطنية موجودة عند هذا التنظيم ولا أبناء هذا التنظيم	NEG
تدني بعض الصحف الرسمية والحزبية والخاصة إلى مرتبة الصحافة الصفراء الباحثة عن الفضائح والمزكية لمشاعر الانتقام والثأر	NEG
لا زالت مستنداتى الرسمية التى تدل على انك حرامى وسارق تطاردك فى منامك، ولا ولن تستطيع ان تواجهها	NEG
سأصوت بلا على تعديلات دستور سقط علشان نعم ستدخلنا في متاهة سياسية ودستورية، وهي انتكاس للديمقراطية	NEG
#حازم_عبد_العظيم اللي خرج من الوزارة لعلاقاتة المشبوهة بشركات اسرائيلية قيادي في حملة #السيسي #الطيور_علي_اشكالها_تقع!!	NEG
إنت فاكر إن متابعتك لأفلامي أهم من بلدي؟ في ستين ألف داهية وإوعى ترجع في كلامك قبل ما تعتذر على جهلك	NEG
شكراً لك ِأيتها المرأة لجعلكِ العالم أكثر جمالاً و روعة لا تتخلي عن أحلامكِ وحقوقك #اليوم_العالمي_للمرأة #ريتويت	POS
الأسواني:اذا لم تتوحد القوى الوطنية فورا من أجل استخلاص الدولة المصرية من أيدي الاخوان فلسوف ندفع ثمن غاليا نحن وأولادنا	NEG
نحب اللغة العربية لأنها لغة القرآن ولأن نبيّنا عربي ولأنها لغة أهل الجنة #اليوم_العالمي_للغة_العربية #غرد_بصورة	POS
انتى عايشه فى مسرحيه عاوزانى اكون كومبارس فى الخلفيه #كاريوكي	NEG
قبضت كام من ساويرس كله في ال #فسسسسسس	NEG
مسيرة مدينة مصر غير مسبوقة يا ويلكم يا انقلابيين من ثورة الشعب العظيم	NEG
الزقازيق الآن حرب شوارع وعلمت ذلك من خلال اتصال بأحد أقاربي هناك ورائحة الغاز تملأ الشوارع	NEG
يجب على كل ابناء #الزمالك مساندة ميدو ودعمه بشكل كبير ميدو استطاع تغير اشياء كثيرة داخل النادى موجوده منذ زمن بعيد قوي	POS
أصابع خارجية وراء خسارة مصر في قطر	NEG
شكر خالص للانقلاب جعلتنا نعرف من هم الاخوان	NEUTRAL
اقتحام السفارة مش سلمي	NEG
عماد متعب || الضابط وجه لي شتائم وتهزئ آخر قلة أدب وأنا معروف، لو واحد غلبان إيه اللي هيحصل معاه يعني	NEG
الله يخربيتك يا سيسي الكهربا قطعت هوبا فلول ستايل #انتخبوا_العرص #مرسي_رئيسي	NEG
بعد صدام الشرطة بالنيابة فى سوهاج شعار الانقلاب الجيش فوق الجميع والشعب مالوش لازمة	NEG
المجلس العسكري نمتلك ادلة تدين 6 ابريل و تدريبهم في الخارج و في الاخر #فسسسسسسسسسس	NEG
انغام وزيره البهجه على رأى #بلال_فضل	POS
مؤتمر فيينا رائع فضح الانقلاب واكاذيبهم وجرذان لفوا العالم لدعم الانقلاب وينفقون بالملايين من اموال الشعب الغلبان	NEG
درس التاريخ أن الإعتداء على مصر يبدأ دائما بضرب سوريا الإعتداء على الشعب السورى همجية وبربرية لا يجب أن تسمح بها مصر	NEG
حد يسأل سيسي لما قال بكره تشوفوا مصر يمكن قصده ان احنا هنبقي شحاتين وهنبقي فرجة والدنيا تضحك علينا	NEG
قسوة مخيفة في رفض الآخر الفكري أو السياسي أو الديني وتشويهه وتخوينه تمهيدا لنزع إنسانيته وممارسة العنف ضده	NEG
ألا يعلم الوزير المتدين أن الكذب حرام، وأن الله لن يقبل صلاته إذا كان كاذبا	NEG
يا صباح الخير يا صباح النصر احنا ملوك كل حاجه فى مصر :)) #الأهلى	POS
لم ولن أتخذ أي موقف يؤيد قتل أبرياء تحت أي ظرف من الظروف ما أقوله عن الإخوان لا يعني تأييدي لقتل أي بريء مهما كان	NEUTRAL
انتخاب مرسي بالقطع ليس سبة ولدى اصدقاء لا اشك في ثوريتهم انتخبوه لكني ببساطة لم انتخبه وقاطعت وان كان هو الان الرئيس الشرعي	NEUTRAL
اذا صدق خبر تأجير الانقلاب الاهرامات لشركة صينية ستكتمل كل اكاذيب وشائعات اعلام العار ضد مرسي الى حقائق وفضائح نفذها الانقلاب	NEG
يوسف_الحسيني يفضح كذب قناة الجزيرة ويكشف تمثيل الاخوان دور الموتي تحت اشراف قناة الجزيرة	NEG
وتتوالى الإبداعات في العالم العربي #اﻷم_المثالية في مصر #سمير_جعجع رئيساً للبنان #والعرص_ابن_العرص مرشح للرئاسة	NEG
الخطأ القومي عندنا هو التبجيل	NEG
ان دفن جثث بعض الشهداء دون فحص اسباب الوفاة يعتبر مشاركة في جريمة قتلهم مع #اسرائيل… هنا #فلسطين	NEG
خطاب مرسي اليوم نسخة مكررة من خطابات مبارك الانفصال عن الواقع والشعارات الفارغة ومحاولة تجميل التزوير والديكتاتورية هل يصدق مرسي ما يقوله	NEG
إنسان أيا إنسان ما أجهلك ما اتفهك في الكون وما أضألك شمس وقمر وسدوم وملايين نجوم وفاكرها يا موهوم مخلوقة لك عجبي! #صلاح_جاهين	NEG
مشربتش من نيلها؟ طب جربت تغنيلها؟ جربت فعز ما تحزن تحاول تولد فأمريكا عشان الواد ياخد الجنسية؟ #شيرين #نفاق	NEG
لا نزول لميدان التحرير لا نزول لميدان التحرير اكررها والا استوعبتوا فخ قذر منصوب لتكرر مذبحة رابعة	NEG
مصر كلها هتصوت لعبد المنعم أبو الفتوح القـوى الأميــن	POS
#تويتة فى عشق الكيان #الاهلى	POS
و انت طيب يا شاعر يا رائع	POS
تأسيسية مين يا أبو تأسيسية إنت ناس إتقتلت تقوللي تحسيسية يا شيخ روح انت وهي إلهي ينتقم منكم واحد واحد	NEG
حاولت اكتر من مره البس بيجاما في البيت واعمل ابن ناس بس الجينز بيستهويني حتى جوه البيت #افضح_نفسك	NEUTRAL
ملايين فى الشوارع قبل العاشرة صباحا مشهد لم يره بلد فى العالم, كم أنت عظيم يا شعب مصر	POS
شكرًا تويتر !	POS
اقطع الصمت التويتري لاهنئ اخويا و شقيقي و كفاءة و كدة بلال فضل بالنص مليون فولور اسبوع و احصلك #حقد_اسود	NEUTRAL
انت حر وماحدش زايد عليك لكن احنا بتكلم في حلول برة تويتر مش حل انك تهاجم اللي بيحاول حتى لو ثبت خطأه	NEUTRAL
#فيفي_عبده_الام_المثالية تقول حككككم	NEG
الحمدلله علي التأهل لدور المجموعات بالكونفدراليه و من فوز لفوز ان شاء الله يا #أهلي #عمرو_جمال - يشعر بـ حالة ممتازة	POS
#المصيبه اللي تقربك من #ربنا احسن من #النعمه اللي تنسيك #فضله	NEUTRAL
لايمكن لانسان ان يقبل وضعه مع الانقلاب لأن الانقلاب يتعامل مع معارضيه كحشرات يضربهم بالرصاص والغاز والمياه تماما مثل الحشرات	NEG
حتى الدور المشرف الذي لعبه الإخوان في حماية الميدان في موقعة الجمل لطخوه عندما قرروا أن يصنعوا موقعة جمل في كل حتة في مصر من أجل مرسي الكذاب	NEG
يحرم علينا شربك يا جوزه روحى و انتى طالقه ملكيش عوزه ! #محمد_محسن	NEG
#أوقفوا_الفحم ياحكومة بقر يا شوية غجر	NEG
من انتصر على نفسه انتصر على أقوى أعدائه و من إنهزم أمام نفسه إنهزم أمام أضعف أعدائه	NEUTRAL
أرفض البيان وادعو للاستجابة لمطلب العزل السياسي للوطني المنحل وإنهاء الطوارئ وجدول زمني لنقل السلطة لرئيس منتخب بعد انتخاب البرلمان	NEG
ساويرس مشغول بالبيزنس وانا والحمدلله لم اقترض من البنوك ولم انحن امام الهانم ولم اشتر اراضي مصر بسعر بخس لابيعها بملايين لا املك الا قلمي	NEG
متابعة الأحداث اليومية والأخبار في الصحف والإنترنت بقت بتستنزف من طاقة الواحد ما لا قبل له بتعويضه،حرقة دم ومناقشة بديهي	NEG
خالد علي: رفع أسعار #الكهرباء و #الغاز و #البنزين ''إجرام سياسي'' بحق #الفقراء	NEG
مصر تستجدى روسيا لاعادة السياح بكره تشوفو مصر	NEG
الانقلابي المليونير حازم عبد العظيم يشكو من ارتفاع فاتورة الكهرباء الله يكون فى عون الغلابة فى الزمن الاسود لحازم وامثاله	NEG
أسلوب النعامة في النقاش غير إنه غبي هو أسلوب حيواني في الأساس داروين كان هيهيص معانا اليومين دول	NEG
مفيش جمهور في الدوري المصري؟ يبقي مفيش كورة اصلا مفيش كورة من غير جمهور #رجعوا_الجماهير	NEG
هو مرسي ما غيرش النائب العام ليه؟ هي دي النهضة؟	NEG
حزن عظيم مسني بالأمس وأنا أشعر بمواطنينا الأقباط يشكرون كل من حضر للكنائس لتهنئتهم بأعياد القيامة وكأنه قام بعمل استثنائي أو غير اعتيادي	NEG
انا مبحبش الناس الأوفر انا مبحبش الناس عموما !! #اعترافات_ليلية	NEG
و لا عاش ولا كان اللي يزعلك يا فوزي	NEG
رحم الله سامر سليمان، كان مصريا مخلصا لقيم المواطنة والديمقراطية وأستاذا متميزا للاقتصاد السياسي، رحمه الله	POS
#مصطفى_حسني #الطريق_الى_الله ناو :)	POS
مصر لسا فيها خير كتييير نعم لباسم #ثورة_25_يناير #باسم_رئيسا_لمصر #انتخبوا_العرص	NEUTRAL
رحم الله جمال البناكان له ككثير من العلماء آراء صادمة وكان لديه النقاء الكافي لإعلانها والدفاع عنها وتحمل ضريبة الهجوملكن عطاءه أوسع بكثير	NEUTRAL
سايب صاحبك يهزر معاك و يشتمك بامك ؟ معلش اصلها فكرت نفسها جابت راجل طلع #سيكو_سيكو	NEG
عاش محمد مرسي مفجر ثورة ديسمبر وحفظ الله الغباء صديق السياسيين الفشلة الوحيد ورحم الله الشهداء السابقين واللاحقين	NEUTRAL
الطرطور: 30 يونيو رد فعل رافض لاستنساخ النظام الأسبق سؤال للطرطور:ماذا فعل القضاء الشامخ للنظام السابق؟	NEG
أنتم تجعلوا من الناموسة فيل الإخوان تنظيم منتهي	NEG
يوم ما #السيسى هيكسب الانتخابات هعملها بروفايل واقوله #ارحل	NEG
هناك فارق بين ان يكون المرشح يسعى لهذا المنصب ليلبى طموحا شخصيا لديه فى اعتلاء المناصب وبين أن يترشح لخدمة الوطن	NEUTRAL
إستبشروا خير	POS
عليك نور !	POS
فلسطين قضيتنا الأولى ، شعار كاذب فحقد البعض على حماس جعله يقذف بالقضية بعرض الحائط ! #غزة_تحت_القصف	NEUTRAL
احنا اسكندرانية ونعجبوك	POS
احنا #الحرية ومعناهــــــــا #الثورة هتاخد مجــــــراها #العزّة ليها طريق معــروف #مكملين #يسقط_حكم_العسكر	NEUTRAL
#دعوة_الصائم_لاترد يا رب عنا علي انفسنا يا رب و اغفر لنا يا رب فانت اهل الرحمه و المغفره يا رب	POS
لما يتم تفجيرات لمدارس البنات في افغانستان تحت دعوى تعليم البنت حرام يبقى ارهابي	NEG
أثق في رؤيةأحمد سعيد وأعلم التزامه بمبادئه وأنا معجب بتصريحه أن الحزب يستطيع أن يكون حزب الأغلبيةوأتمنى فوزه في الانتخابات لتحقيق تلك الرؤية	POS
سعيد بمجهود صديقي شادي شريف و فريق جمهورية تي في , ومبروك على البرامج الجديدة لابراهيم الجارحي و حسن حامد	POS
2008 المنصورة مدرسة احمد زويل لجنة 9 القاضى بيسود بطاقات بايدة ولما اتصور عمل مشكلة وجارى عمل محضر لة	NEG
ومازال الأستاذ جمال عيد حتي الأن ولأكثر من ‏14‏ ساعة مابين قسم عابدين ونيابة عابدين دون اي سبب واضح إلا التكدير والإرهاب فقط	NEG
الساكت عن الحق جبان ! لا مال و لا شئء ينفع فى الآخرفمن يقف على الحياد بين الحق و الباطل فهو مع الباطل بالتأكيد	NEG
اهو دا اللي صار: رائعة #سيد_درويش بصوت الجميلة #دينا_الوديدي	POS
#اعتراف انهرده كان يوم عالمى وكله بان على حقيقته	NEG
أشكركم جميعاً على وقتكم الثمين والساعة لا تكفي معكم	POS
البنك المركزى التابع للانقلاب يعلن أن ديون مصر ارتفع لمستوى بشع غير مسبوق وتجاوزت 1,8 تريليون جنيه كارثة لا يشير لها اعلام العار	NEG
الانقلاب ينهب اموال الناس من البنوك وغدا يرحل ويترك المجتمع خرابة من يرد للناس يومئذ فلوسهم	NEG
لا تقحمونا في سياستكم القذرة #الكورة_للجماهير	NEG
برطمان حنية مليان زيادة وماشي بيدلدق #الأسد	POS
#باسم_طلع_حرامى باسيييييم مهزوز علشان اتفيش	NEG
يقول رسول الله صلى الله عليه وسلم: "يُقال لقارئ القرآن اقرأ وارتق ورتل كما كنت ترتل في الدنيا، فإن منزلتك عند آخر آية تقرؤها"	POS
المادة 139: 16 معترض وبعد نقاش 8 دقائق يعاد التصويت على النص يعترض 4 فقط لمنع تأجيل 48 ساعة بحسب اللائحة! #سلق_الدستور	NEG
الافلام الجديدة لمذبحة رابعة اقدمها للسفير ابراهيم يسرى ليعيد التفكير فى مبادرته ولكل من يفكر فى عمل مبادرة جديدة	NEG
#حركة_كايدينهم #مصر #قول_كلمه_للسيسي_وخد_فولو_هديه ياسيسى يا اصيييييل #احنا_شباب_هنصوت_للسيسى #سأنتخب_السيسي	POS
فريق الوعد #إنصاف_الإخوان	POS
ده تسيب #انتخبوا_البرص	NEG
من يقف على الحياد بين الحق و الباطل فهو مع الباطل و عندما ينتهي كل شيء لن تذكر شيئا من كلمات أعدائك لكن صمت أصدقائك سيترك أثرا لن يزول!!	NEG
# تقريبا دي اكتر حاجة قريتها جسدت المذبحة اللي حصلت لاقرب ما يمكن #مذبحة_بورسعيد	NEG
محاولات الترقيع المستمرة لدستور سلطوى تسير فى الإتجاه المعاكس للديمقراطية دستور مؤقت ثم البدأ فى صياغة دستور ديمقراطى هو مدخلنا للديمقراطية	NEG
يبدو انهم يريدون ارهاقنا بدنيا و نفسيا و ماليا	NEG
#الشبراوية_مع_الشرعية|#حاميها_حراميها الآن من مسيرة #شبرا_الخيمة بالجزيرة مباشر مصر #العز_بن_عبدالسلام	NEG
المجد لله ثم لك انت ياشهيد #جـــيكا #سيد_وزة	POS
قوة هدفها استكمال نقل السلطة للمدنيين المنتخبين وبناء دولة المواطنة والقانون المدنية ورفض ممارسات الاستبداد والمنافسة الانتخابية الجادة	POS
الدكتور #مصطفي_محمود بيشرح بطريقة بسيطة	POS
الكرامة لا تعوض بالأموال، وهي ليست سلعة تباع وتشترى، والإمارات لديها أموال ولكن ليست لديها "كرامة" كالعاهرات تمامًا	NEG
شكرا ياشباب على محبتكم ربنا يجعل كلامنا خالصا لله والوطن ده رابط تحميل المعصرة مقالة أحمد زكي مهمة تصبحوا على خير	POS
لا يوجد دم إخواني وآخر معارض ومتمرد، فقط دم مصري، نبذ العنف ضرورة والسلمية مسئولية وطنية وإنسانية، أنعي الشهداء	POS
انقطاع الكهرباء كانت الوجبة الرئيسية لبرامج العار على قنوات الفساد فى زمن مرسي الانقطاع تفاقم اكثر والاعلام صمت القبور	NEG
كانت فين الروح الحلوة دي أيام زمان نص مليون فرق في الفولورز فعلا بيغيروا الإنسان متشكرين يا مبهج الجماهير	POS
ربي بلغنا رمضان من غير أن نرى دمعة حبيب، ولا فراق غالي، ولا استمرار مرض لقريب، اللهم بلغنا رمضان لا فاقدين ولا مفقودين#رمضان_كريم	POS
إخفاء الحقيقة بحجة ان الرئيس يعلم ما لانعلمه وهو بيده الامر ويعرف مصلحتنا فكرة خانعة تكرس لتهميش المواطن واحتقاره الرئيس موظف عند الشعب	NEG
احقر انسان هو اللي سكت عن الانقلاب في مصر وعقبها قال ما يجوز الخروج على السيسي لانه ولي أمر #إنصاف_الإخوان	NEUTRAL
اللهم ارزقنا نعيم الجنه آمين	POS
الأعداد في مسيرة مدينة نصر جبااااااااارة تذكرني ب ٢٨ يناير	POS
إقالة يحى حسين بكل رقيه الاخلاقى وإخلاصه الوطني وكفاءته المهنية جريمة جديدة لسلطة غشوم جهولسينتصر يحيى مجددا ويندحر الصغار المنتفخون	NEUTRAL
كل عام وأنتم بخير وكل منا في سلام مع نفسه ومع الغير وفي وطن يتسع للجميعمازالت قناعتي أن شباب مصر الثورة هم الحل والأمل:فكر خلاق وقيادة فتية	POS
لا اعرف الدكتور هشام قنديل و من عدم الإنصاف ان نحكم عليه قبل ان يبدأ لننتظر التشكيل الوزاري و نعطيه فرصة ليعمل ثم نقيم اداءه	NEUTRAL
رئيس يطبق الشريعة دون أن يكون مسلما ولايسير في مواكب مصفحة ولا يكذب على الناس بحركات إستعراضية ويفتح قصره للفقراء	POS
أرفض تماما وأدين ضرب الصحفيين أمام كنيسة السيدة العذراء لا لأخونة الكنيسة	NEG
مساعدة المحتاجين #خلق_جميل	POS
مواليد برج #الأسد تعجبك صداقتهم كثيراً	POS
بيقولك #صباحى نفى تصريحاته عن محاكمة #السيسى و قال عنه إنه بطل شعبى -عندة اننفصام فى شخصية الحزين ده والله !	NEUTRAL
مشروع قانون الشوري للمجتمع المدني ومشروع الرئاسة "المعدل"يعكسان العقلية الأمنية الإستبدادية التي ثورنا ضدهاثم يتساءلون لماذا يتمرد المصريون	NEUTRAL
لما تقول لأنسان بسيط كلمه حلوه تسعده #خلق_جميل	POS
المفترض ان حضرتك تبلغي انت وزميلك الشرطة واعطائهم كافة المعلومات ولاتنسوا #باسم_يوسف_طلع_حرامي #اخوان_ابليس #الاخوان_جماعة_ارهابية	NEG
هل ستستمر مكافحة #الارهاب بالشعارات والأغاني الوطنية ؟! #كفى_عبثا واستهانة بأرواح الأبرياء	NEG
#نبض_الاخوان | #زواج_امريكا_من_مصر_باطل حشود هائلة ل ثوار #المطرية وشبرا الخيمة الجمعه 2/5	NEG
أيها الاخوان الا تذكرون 52 شهيدا قتلتهم شرطة محمد ابراهيم بأوامر من مرسي عندما شكر مرسي القتلة واعلن حظر التجول اعترفوا بجرائمكم	NEG
وزيرة البيئة تعترف ان مشاكل القمامة لن تحل الا بعد 10 سنوات الاعلام ذبح مرسي بعد 100 يوم لانه لم يحلها	NEG
محاولات مستمرة مقيتة منذ أول يوم للالتفاف حول ثورة الشعب المصداقية اليوم على المحك	NEG
اوعى تهدم بلدك - قصة صاحبة القصر	NEG
مرسي هو السياسي الوحيد الذي حاول أن يصبح طاغية دون إنجاز، ويبدو أنه لم يسمع عن القاعدة العلمية التي تقول "طاغية دون إنجاز مثل شباك بلا إزاز"	NEG
يحيطك دائما بما يشغلك #فضيحة_المحلة #مرتضى_سما #ابله_فاهيتا الخ يتغير الزمن ولا يتغيرون يلهونك بقنابل الدخانليطبخ "برواقه" الله غالب	NEG
بطاقة دعوة #زواج حلوه لـ #الواتس_اب من تصميمنا رتويت ي حبايبي :$	POS
لا تجبر الإنسان ولا تخيره يكفيه ما فيه من عقل بيحيره اللي النهارده بيطلبه ويشتهيه هو اللي بكره ح يشتهي يغيره عجبي !! #صلاح_جاهين	NEUTRAL
امارات الندامة تفرض شروطها لاستمرار دعم الانقلاب قبل اربعين سنة كانت اكبر امنية اى بدوى منهم انه يزور مصر منك لله يا سيسي	NEG
هل عمرك قابلت حد بيفهم وفي نفس الوقت بيدعم المتأسلمين عن قناعة مش للمصلحة؟	NEG
باسم يوسف لذيذ	POS
إذاغيب الموت "نعناع الجناين"فإن حكاء مصرالأصيل سيظل حاضرافى الوجدان المصرى بأعماله التى جسدت أحلام المهمشين،رحم الله"صياد اللولى"خيرى شلبى	NEUTRAL
كل التضامن مع ثورة شعبنا العربى فى اليمن من أجل الحرية والديمقراطية والعدالة والوحدة ثورة الشعب العربى ممتدة من المحيط إلى الخليج حتى النصر	POS
الفراج يشن هجوم بطريقة قذرة على اتحاد " منتخب " ويتحدث عن العدالة و يبرر العنصرية #فلول #اكشن_يا_دوري	NEG
العيال الاخوانجية السفلة عاملين مولد لسيادة #المشير #السيسى فى حلوان بالطبلة والصاجات!!	NEG
#مصر لا يوجد خبر أسخف من حل الإخوان ما جرى منذ الانقلاب أسوأ كثيرا من الحل ،البلاد بلا دستور ولا قانون واختطف …	NEG
#خليك_مصدق إن فيه ثورة فى العالم قام بيها وزير دفاع ووزير داخلية !!!!!! #هبل_وهطل_شعب!!	NEG
من أعظم نعم الله عليك أن يقضي حوائج الناس علي يديك فاكر آخر إنسان ساعدته؟	POS
حرية الحركة الطلابية وحقها فى العمل السياسى جزءأصيل من الحريات العامة التى ناضلنا من أجلها منذ السبعينياتالثورة تفرض لائحة طلابية ديمقراطية	POS
سبحان الله وآلحمد لله ولا إله إلا الله ولآ حول ولآ قوة إلا بالله والله أكبر واستغفر الله #اذكر_الله #غرد_بذكر_الله 41	POS
#شاهر_المؤمنين عالم رياضيات #أردني ينضم الى قائمة اهم علماء #الرياضيات #عالمياً ، نفتخر بعلمائنا مبروك للأردن #اﻷردن	POS
لما اعرف ان #محمد_رمضان عامل مسلسل في رمضان الجاي اسمه ابن حلال أمال مين اللي يبئه ابن كلب	NEG
فضلوا يبرروا بمعايير بيئية صارمة لاستخدام الفحم في مصانع الاسمنت وفي الآخر سمحوا باستخدام الفحم بدون موافقة البيئة #أوقفوا_الفحم	NEG
كل همنا انقاذ الوطن وعدم اعادة النظام القديم عن طريق إطالة الطوارئ و الاطاله في الفتره الانتقاليه	NEUTRAL
شاركونا على تويتر يا شباب #خلق_جميل تعالوا ننشر على الهاشتاج ده أخلاق نحب نراها فى مجتمعاتنا و يتخلق بها	POS
انتظرت فى التعليق على مقال فهمى هويدى حتى قراءة الجزء الثانى الذى نشر اليوم وللاسف: ما طلبه هويدى لا يجرؤ اى انقلابي على طلبه	NEG
#اللهم زد أحبتي #عفواً وعافية وتوفيقاًً وسداداً وصلاحاً #وأحفظهم من كل سوء #صباح الخير	POS
عا أمن الوطن ساهر بنحيي العميد #ماهر انا وياك	POS
انخضع للإرهاب؟ هذا ليس حل	NEG
أبو الفتوح فى الدويقة: كانت تحكمنا عصابة لم نر مثيلا لها فى التاريخ - بوابة الشروق	NEG
7_ أنا نشرت توضيح لفيديو تم إستغلاله بشكل واطي مش معنى إن الأمن مفتري يبقى كل اللي بيقولوه الإخوان صح	NEUTRAL
خامس مرة فيه بيان إدانة أو استنكار أو تعزية صدر عن الإخوان فيمن مات أو اختطف أو عذب من الجند والعمال والأهالي غيرالإخوانج…	NEG
فوشيا+موف+بنّي+دهبي+ ٢ كيلو دقيق أبيض تحت العينين ياااااظلمة س	NEG
البطل الشرقاوى أحمد الشحات يجدد ذكرى سليمان خاطر وسعد ادريس حلاوة وأيمن حسن تحية لأرواح شهدائنا ونضال المقاومين المستمر ضد العدو الصهيونى	NEUTRAL
__ حاضر حنسكت و مش حنقربله بنقد او سخرية عشان هو الاغلبيةحاكون امعة و امشي مع الرايجة حاضر	NEG
? # #" وجودكم يا شباب وغيرتكم علي بلدكم علي اختلاف افكاركم يملؤني بالتفاؤل	POS
٢ بابا الأزهر وشيخ الكنيسة دعامتان لعصابة الانقلاب ترزى الفتاوى علي جمعه حاضر دائماً لعبوا علي الغرب لكذبة حرق الكنائس واضطهاد الأقباط	NEG
اعتصام عمال ''بلاتنيوم'' داخل ميناء السخنة #حاميها_حرميها #الجيزة	NEG
قد ﻳﺒﻄﺊ ﺍﻟﻨﺼﺮ ﻷ‌ﻥ ﺍﻟﺒﻴﺌﺔ ﻻ‌ ﺗﺼﻠﺢ ﺑﻌﺪ لإ‌ﺳﺘﻘﺒﺎﻝ ﺍﻟﺤﻖ ﻭﺍﻟﺨﻴﺮ ﻭﺍﻟﻌﺪﻝ ﺍﻟﺬﻱ ﺗﻤﺜﻠﻪ ﺍﻷ‌ﻣﺔ ﺍﻟﻤﺆﻣﻨﺔ سيد قطب	NEUTRAL
(ذلكم بأنه إذا دعي الله وحده كفرتم وإن يشرك به تؤمنوا فالحكم لله العلي الكبير) [غافر:12] #أحبك_ربي	POS
' كله كاتب فــ الـ #ثانوية_عامة -_- #ثانوية_عامة بقيت موضه -_- -	NEG
ﻫِﺠﺮﺓٌ ﺇﻟﻰ ﺍﻟﻠِﻪ -ﻋﺰ ﻭﺟﻞ- ﺑـ #اﻟﺘﻮﺣﻴﺪ ﻭ #ﺍﻹﺧﻼﺹ ﻭ #ﺍﻹﻧﺎﺑﺔ ﻭ #ﺍﻟﺘﻮﻛﻞ ﻭ #ﺍﻟﺨﻮﻑ ﻭ #ﺍﻟﺮﺟﺎﺀ ﻭ #ﺍﻟﻤﺤﺒﺔ ﻭ #ﺍﻟﺘﻮﺑﺔ	POS
جالس العلماء وزاحمهم بركبتيك فإن الله يحيى القلوب بنور الحكمة كما يحيى الله الأرض الميتة بوابل من السماء #مصطفى_ح	POS
حزن أم كره؟	NEG
عندنا القضاء "الواقف" وهو المحاماة والقضاء "الجالس" وهو القضاة والعدل "النائم"!ا #جلال_عامر	NEG
أَسْتَغْفِرُ اللَّهَ الَّذِي لا إِلَه إِلا هُوَ الْحَيُّ الْقَيُّومُ وَأَتُوبُ إِلَيْه #غرد_بذكر_الله	POS
#الارهاب خسة وانحطاط تحيا مصر	NEUTRAL
#مصطفى_حسني : إلهي وسيدي نفسي أشكرك على أي حاجة هتعملها قبل ما تعملها لإني متأكد إنك مش هتعملي إلا كل خير #أحبك_ربي	POS
الرابط اهو للاخوة المشككين علي موقع الجزيرة مباشر - إخوان وبقا 60? لا!!	NEUTRAL
الفرق بين الداعية الديوث والشرشوحة خالتي فرنسا أن خالتي فرنسا تابت ولم يكن لها الحظ بالعمل في تقديم البرامج الدينية	NEG
اللي بيقول التحرش نقص دين في اوروبا معظم النتس مش متدينين ده نقص اخلاق و اللي يقولك حرمان كتير من المتحرشين متجوزين	NEG
الأداء المخزي لبعض الشخصيات التي كنا نسميها مستقلة يثبت أن كل ما في الأمر أنها لم تأخذ فرصتها في النفاق لمبارك لأن كل الكراسي كانت محجوزة	NEG
تلك الايام لما كنا ننتقد الاخوان يقولوا مش وقته تغلطونا دلوقتي،نخلص من العسكر و بعدين اعملوا اللي انتوا عايزينه، هيييه دنيا!!	NEG
#علاء_عبد_الفتاح زعلان أنى الميسيحين #بيصقفو #للسيسى وبيفكر #الميسيحين بى #ماسبيرو علاء #وشلتو #الدم هو #تجارتهم_الرابحة لى…	NEG
الأسواني للرئيس: لا تظن أن الكذب يضركبالعكسالكذب اذا تكرر بكثافة سيؤدى الى تشويش أذهان الناس حتى المقال كاملاً >>	NEUTRAL
تعليق صباح على تسجيل #حمدين_صباحي بشأن محاكمة #السيسي #تحيا_مصر #مصر #الاخوان #باسم_طلع_حرامي #حركة_كايدينهم	NEUTRAL
#محمود_سعد اعلامي قذر بعد اذاعة فيديو خيانة #حمدين قال لم اسمعه جيدا ولم يعلق عليه لانه ليس اعلامي بل افاق ومن…	NEG
علي سبيل #الآآدمان القـاتل :- " #ميرنـدآ_تفـآح #شيكولآآته #شيبسي [[ ]] " لو بتحب حآآجة فيهم لآآيك :)	NEUTRAL
رضاك يارب #كلمتين_وبس	POS
أسف يا ريس،رغم إنتمائي للأخوان إلا أنني إبن ثورة الحرية لذلك ارفض السلطات المطلقة للرئيس مهما كانت السبب وأي كانت المدة	NEG
عملية الاعتقالات المستمرة لرموز رفض الانقلاب هدفها الرئيسي مساومة هؤلاء على حريتهم مقابل التنازل عن حرية شعب!! لكن الله ثب…	NEG
كام واحد هنا فهم إني قاصد أقول إننا حيوانات في زريبة مش إن ده لسان حال اللي بيقولوا إن حقوق الإنسان سلعة غربية؟ #مرار_طافح	NEG
‏ الأسواني:ان الجرائم التى يرتكبها الاخوان المسلمون تتزايد كل يوم وبالرغم من بشاعتها فهي تكشف حقيقة الاخوان التي ‏	NEG
فيه ناس بتبعتلي رسائل عتاب رقيقة جداً والله يا جماعة أنا ما عنديش أي نية أكون كاهن ولا ملاك وبقول للخروف يا خروف في وشه ومش هتغير	NEUTRAL
281 أعتقد إنك لو مقتنع بالكلام ده يبقى دي مشكلة من نفس النوع لو انتم ملايين يبقى روحوا إعملوا عصيان مدني ورِّينا	NEG
أؤكد على حق جماعة الإخوان في الاحتفاظ بترخيصها كجمعية أهلية ومزاولة نشاطها الأهلي في نطاق القانون الذي سنه برلمانها--لا ل…	POS
الروايات متضاربة ومتناقضة حول احداث طريق النصر الحل تحقيق عادل مستقل شفاف لاستجلاء الحقيقة ولا يجب ان يفلت من أجرم من العقاب مهما كان موقعه	NEUTRAL
لا ولن أوظف أبدا عمل الخير للانتخابات أو السياسة دعوت للتبرع للخير قبل رمضان واستخدمت تويتر وفيسبوك كوسيلة للتواصل وليس لمغازلة مصر الجديدة	NEUTRAL
_ البراءة من قتل المتظاهرين كانت 15 أبريل 2013 علشان معلوماتك تبقى صح يعني في عقر حكم الإخوان ولم يستأنف قبل ال60 يوم	NEUTRAL
لو كان الأمن هيحل فشل السياسة كان حل فشل مبارك وفشل طنطاوي فشل السياسة لا يحله إلا سياسة ناجحة وذكية وغير كده نزيف دم إن كنتم تعقلون	NEUTRAL
كائن بوليسي اسمه لواء حمدى بخيت علاقته بالانسانية والكرامة زى علاقته بربه الاتنين مقطوعين	NEG
الفرق بين شجاعة طالبات الثانوي بالمحلة وجبن مسئولي التعليم ونذالة الاخوان هو ذاته الفرق بين مستقبل مصر وماضيها المستقبل قادم وسينتصر حتما	NEUTRAL
المناخ.. معاناة تتواصل رغم المحاولات 	NEG
احنا كدة مش بنتشطر غير علي بعضينا #المصريين	NEG
الشعب هو البطل الوحيد!	POS
#أوقفوا_الفحم :)	NEG
بنساعد أي حد عاوز الخير للغير خيرنا هيعرضلك كل الخير إللي ممكن تعمله و يوصلك بكل المبادرات و الجمعيات #مب	POS
لمن يعتقد ان صداقتي بجون ستيوارت اليهودي تهمة,شوفوا حلقاته:هاجم منع المآذن في سويسرا,ومنع مسجد منهاتن وهاجم اسرائيل في اللي بتعمله في غزة	POS
هل الفرح حرام ؟ كان الخطأ الأول لزملاءنا الإنقاذيين وإعلامهم ، هو امتناعهم عن المساهمة فى إنقاذ وتحرير جنودنا من	NEG
ياريت بس الإخوان يوحدوا الكذبة هوه مرسي جامد قوي وبيحبط مؤامرات شرسة؟ ولا مغلوب على أمره والدولة كلها ضدهكدب مساوي ولا صدق مجعرف يا إخوة	NEUTRAL
يا له من عالم "مزري" !!! -_- #تويت_بخطك	NEG
د علاء الأسواني: متى يتحول المواطن في الدول الديمقراطية والتي تكفل حقوقه كاملة الى مجرم يجب محاكمته وعقابه ؟! >	NEUTRAL
تبااااااااااااااااااااا لك ياااااااااااااااااااا #مارك وأخير استطعت تغيير إسمي دعواتكم أصدقائي كي أتمكن من استرجاع إسمي الأول	NEG
كلما كرر حزب النور افعاله الوضيعة كلما تذكرت الفعلة الحقيرة لممثلهم البرلمانى البلكيمى	NEG
#برنامجي_المفضل #3 #أوسكار	POS
_ مصر خسرت أرواح أبنائها التي لا تعوض بمال السعودية أوالامارات	NEG
البنات اللى بيقولو ألفاظ خارجه دول خصاره فيهم يتسموا بنات اصلاً!!	NEG
حاجات_بتفرح_في_مصر اللمه الحلوه مع اصحابي	POS
جيل الوسط هو الذي شغلته أسئلة ومشكلات عصره باحثين عن الحقيقة	POS
ما حدث مع المعتصمين يتحمل مسؤليته المجلس العسكري أين دور رئيس الوزراء في ضوء الصلاحيات الكاملة الممنوحة له #	NEUTRAL
#جمعية_الاقل_من1000_فولورز أدركوا اللحظه لن تنعموا بالفولورز مرة اخرى المجد للكادحين لقد ولى زمن النخب	NEG
مليارات الانقلاب للاعلام الاميركى لن تحسن صورته يدفعون للغرباء من اجل عمل حرام ويدفعون شعبهم الى الجوع والهوان	NEG
2050 بص يا سيدي انا ضد فض أي اعتصام بالقوة وأعلنت ده بعد الحرس الجمهوري وأيضاً غلق المحطات ولكن هذا لن يجعلني ادعم طفاسة قيادات فاشلة	NEG
إمام مسجد سيدي جابر طلع علي المنبر و استقال و قال الأوقاف عايزاني بالعافية اوجه الناس لتأييد قرارات الرئيس في الخطبة	NEG
إن ذكر الرحمن يُذهب الأحزان #أحبك_ربي	POS
الأسواني: الدم سوف يعلق بيد كل من يشترك في هذه الانتخابات الباطلة فلنقاطع الانتخابات وننضم الى	NEG
دعبد المنعم أبو الفتوح ( التعدديه اثراء وتنوع واكثر فائده للمجتمعالتعدديه مطلوبةوهى ليست انقسام وفرقة)	NEUTRAL
مبروك ومبروك - ولكل الزملاء واشكر كل من ساهم بانجاح هذا الانجاز الراقي اليوم #نقابة_الصحفيين	POS
ثمان غارات بالطائرات ل #النظام على مدينة #دومة وخمسة عشر على #المليحة في #الغوطة_الشرقية نسأل الله أن يرد كيدهم في نحرهم وأن…	NEG
وحدتنا التي أفسدتها بإخلافك المستمر لوعودك؟ والإعلان غير الدستوري الذي قسم المصريين؟ ": قوتنا في وحدتنا #الرئيس"	NEG
من كثر التحلطم اللي يسري بدم الكويتي حتى إذا شاف سيارة مكتوب عليها " ما شاء الله" #لازم يقول : شدعوه عندك فراري عاد	NEG
ابو اسماعيل امه امريكية لا مش امريكية طب فين الجرين كارد طب ده ماسك عيكم مستندات و فالاخر #فسسسسسس	NEUTRAL
#توفيق_عكاشة: #محمد_رمضان دا شمام وسمكري بوابير جاز	NEG
#ابراهيم_عيسى ساخرا : هل يوجد علاقة واضحة بين تاريخنا #السياسي و (الراقصات) #العوالم	NEG
وكما ادخل المجلس العسكرى نفسه دائرة الشبهات فإن اللجنة قد وضعت نفسها بهذا القرار فى مرمى السهام، اللجنة والمجلس وجهان لعملة واحدة	NEG
تهنئة لكل طالب وطالبة قضوا ما يزيد عن 150 يوماً معتصمين وواجهوا كل انواع التنكيل #جامعة_النيل	POS
حاميها حراميها 	NEG
#نفسك_فى_أية_فى_الجنة_؟ نكلم الرسول صلى الله عليه و سلم =]	POS
ولي ولي العهد!! معالي وزير الوزارتين!! #عشنا_وشفنا	NEG
لن تتقدم #مصر طالما بقيت فيها أبواق للتدليس مثل #هيكل وطالما بقيت فيها آذان تستمع له وعقول تنبهر به وبتخاريفه وحكاياته…	NEG
طالما إنت مصدق إن الداخلية كانت بتغطي حمادة مش بتعريه ولا تسحله أنا كمان هاصدق إنكو بتبعتو ناس تغتصب البنات في التحرير وتقتل الناس في كل حتة	NEG
#السعاده ان يكون من نحب بخير وعافيه فنحن نشعر بهم ونهتم لامرهم حتى لو لم نراهم 3"	POS
احد ضحايا الاخوان اصابوه برصاصة في قدمه ثم عذبوه ببشاعة داخل الجامع هو احمد ثابت عضو 6 ابريل وهو يعالج الان في مستشفى البترول بالإسكندرية	NEG
لا تنتصر لنفسك و لكن انتصر للحق و تعلم من الإمام الشافعى حين قال : ما ناظرت أحداً قط إلا تمنيت أن يجرى الله الحق على لسانه	POS
#اكتب_رساله_لشخص_دون_ذكر_اسمه الحياة ي صاحبي أجمل من بشاعة الحزن لا تحزن ابتسم وتفائل دائما ، وكن على يقين لن يصيبنا إلا …	POS
الصبح لما بييجي ببقي حاسس بإنتصارالليل يعدي عليا وأنا واقف في إنكسارأما ما بينهم في عزيمة وقرارات بتضيع علي أخر النهار #كراكيب #وسط_البلد	NEUTRAL
04 _ # تدعون للدين وتنشرون الأكاذيب، لم أكن أبدا عضوا بالوطني انتم تتاجرون بالدين	NEG
مسيرة احرار وجدعان #المعادى الان #حاميها_حراميها #مرسي_رئيسي مكملين	NEUTRAL
منع "#سما_المصري" من الغناء بمصر لتحريضها على الفجور #السعودية #الرياض #الدمام #القصيم #تبوك #جدة #القطيف #العوامية	NEG
#دعوة_الصائم_لاترد اللهم أغفر لي ذنبي وأجلي همي وبدد وحشتي وأنر قلبي بذكرك وطاعتك وأجعل الخير مفاتح دربي والصدق نور طريقي	POS
في مواجهة نظام الملالي المجرم فالحل الوحيد هو الصمود والنضال ضد غاصبي حق سيادة الشعب والعمال والكادحين #عيد_العمال #اي…	NEG
اجمل ما رأت عيني في #معرض_الكتاب ، ️	POS
تفووووووووو #غزة_تحت_القصف	NEG
مضمون كلمة الرئيس، الاستعلاء على المطالب الشعبية والدفاع عن الأخطاء عوضا عن التراجع عنها وتبرير عنف جماعته ودعوة حوار شكلية، لك الله يا مصر	NEG
دراما رمضان المصرية.. الكباريه الكبير 	NEG
و الكائن الهلامي المعرض اللي كان مقوم الدنيا على حكومة #هشام_قنديل و ساكت على حكومة #محلب رمز الحزب الوطني #حرامية_الدعم	NEG
#عيد_الأم الام هي عيد الحياة	POS
أنا ضد التمويل الاجنبي تماماً الغريب ان ينتسب البعض الى الاسلام ويستغلون فقر الناس ويشترون اصواتهم ثم يتبارون في البذاءة اى اسلام هذا	NEUTRAL
انا الآن اعاني من اقسى انواع الطفش #فكرة_جميلة يحطون غرفة نوم بالجامعة اروح اخذ غفوه بالبريك	NEUTRAL
#اطفال دول ولا مش اطفال ؟؟؟ظظ يابتوع #المدارس هههههههههههههههههههههههههههههههههههههههههههه	NEG
عمري ما كنت اتخيل اني هتحاور مع قتلة او متورطين في قتليتبع	NEG
بالنسبه للبنات الى لما بترتبط مابتكلمش ولاد دا محن صح :) بصوت عمر مجدى #كفاية #محن #بقي	NEG
عارفين يعني ايه للعدالة وجوه كثيرة!! يعني #كله_ماشي :(	NEG
غياب العدل فى وطنى يبشر بانفجار غضب بركانى شعبى #يسقط_حكم_العسكر #الداخلية_بلطجية #انتخبوا_العرص	NEG
#مصر • رفع شعار رابعة اثناء كلمة اوباما ف ماليزيا المؤمن للمؤمن كالبنيان المرصوص "(ઊ316) #انتخبوا_العرص	NEUTRAL
لا أمل فى دولة تدخل فى حرب مع اعدائها لتحرير ارضها منهم ! #تويت_كأنك_ناشط_ايام_حرب_اكتوبر	NEG
كل الدساتير الماضية سقطت لانها لم تكن وفق ارادة مجتمعية #السادة_المحترمون	NEG
"25: #الميدان:مفتي الدم الانقلابي صدق على اعدام 37 من 528 تم احالة اوراقهم اليه "	NEG
اذا عارضت المرشد فانت عند الاخوان فلول او علماني عدو للدين الا يمكن ان يكون الانسان مسلما وثوريا ووطنيا ومعارضا لقرارات المرشد ممكن ؟	NEG
تبقى بجد في كوكب القرود إذا إفتكرت إن شعبيتك تزيد بممارسة التسويف والقمع والتدليس والنفاق لتبجيل وتبرير ديكتاتورية فجَّة	NEG
اللهم اغفر لأمواتنا وارحمهم وعافهم واعف عنهم واكرم نُزلهم ووسع مدخلهم واجمعنا بهم في جنانك #دعاء #دعائي #غرد_بذكر_الله #أدعية #يارب	POS
70 لا يستطيع ان يجزم احد مدى تعب الحمار سوى الحمار نفسه لذلك أرجو الا تكون متأكد من كلامك	NEG
": النِعمة تحتاج للشكر،، وَالبَلاء يحتاج للصبر،، وَالذنَب يَحتاجُ للإستغفار،، (فمْن شكرَ و صَبر وَ اسْتغفَر نَال #السعادة) 50"	POS
هل تقرأ القرآن بعد رمضان؟ هل تفهم معانيه وتفكر فيها؟ هل نويت أن تختم القرآن بعد رمضان؟ هل تعرف ثواب قراءة وتدبر	POS
هل هذه هي الديمقراطية؟ هل وزعت أيضا أموال على طلاب جامعة النيل والقيادات النقابية لزعزعة الاستقرار؟ هل بالأمن والقمع سنتعامل مع الاحتجاجات؟	NEG
يجب فصل الحركة الدعوية عن التنافس على السلطة السياسية	NEUTRAL
التليفزيون يعرض ميادين خالية اغلقها الجيش ويترك اربعين مليونا بلا تغطية درية شرف الدين فين مظاهرات الشعب اهوه	NEG
تعرفوا الضابط اللى قبض على #هيثم_محمدين نزله ليه وفتشه !!؟ عشان ذو لحية و شعر طوال ? و كتب كده ف المحضر و اتكسفش على دمه	NEG
هل توافق علي تبكير الانتخابات الرئاسية و الاسراع بنقل السلطة من المجلس العسكري ؟؟ للاشتراك فى الاستفتاء يرجي	NEUTRAL
الاعتراف بالخطأ #خلق_جميل	POS
الله وصف #البنات ب ناقصات عقل و دين , و اعطى #الراجل الغضب و العصبيه و طلب منهم يكونو شعوب و قبائل هههه الي رايح حقو الزلمه هيتحمل كتير	NEG
"_4: #السعاده: أنتِ بذاتها و الفرحه عيونك •"	POS
و زي ما الإخوان و السلفيين اعتبروني عدو للإسلام كتير من الإعلاميين اللي وقفوا معايا حيقلبوا عليا قريب جداً الفاشية لا دين لها	NEG
الحملة الشعبية لمكافحة الأفْورَة	NEG
قالوا السياسة مهلكة بشكل عام وبحورها يابني خشنة مش ريش نعام غوص فيها تلقى الغرقانين كلهم شايلين غنايم والخفيف اللي عام #صلاح_جاهين	NEG
#قنديل لـ"#السيسى": عليك تقديم برنامجك الانتخابى وعدم التعالى على الجماهير #أخبار_مصر #الفجر	NEUTRAL
الحل هوتوحيد المطالب إقالة النائب العام وتطهير القضاء والشرطة ومنع المحاكمات العسكرية ثم انتخابات تنقل السلطة الى المدنيين بأقصى سرعة	NEUTRAL
هل السرب الذي تطيرخارجه #قطر هوسرب صلاح الدين وابن الخطاب وعلي؟وهل ل #دحلان و #خلفان والأم المثالية-أجنحة؟هل ينبت للزواحف ريش ياقوم؟#احسان	NEUTRAL
الاعدام ل #صغار_الخنازير #بديع #المرشد #الاخوان #المنيا #مصر #السيسي	NEG
الطريقة الوحيدة لتعبرك امك فيا أنو تحكيا عالواتس اب -- #عشنا_وشفنا	NEG
لمن لم يشاهد لقاء مصعب الشاعر مع محمود سعد - نموذج لطهارة ثورتنا التي اتسخت بقذارات السياسة …	NEUTRAL
ده مش جيل 54 زى ما هيكل كان فاكر ده جيل 25 يناير ورابعة جيل العزة والكرامة والصمود صورة للأسود في الزنزانة …	POS
من لايعرف أمه إلا يوما في #السنة فهو عاق لها ومن يصلها ويهديها ويبرها #كل_يوم فلا معنى لـ #عيد_الأم عنده فعيد الأم مناسبة للعا…	NEUTRAL
طب لما يغلوا #البنزين و #الكهرباء و #الغاز حيستعملوا #الفحم برضه فى توليد #الطاقه !؟ #لا_لغلاء_المعسل	NEG
عزيزي المتطرف: قبل أن تستخدم تعبير أسد في وصف شيخك، فكر قليلا في مشاعر السيدة والدته	NEG
اللهم انتقم منه انتقم من كل من فرح بدماء المسلمين والله لنقف يوم القيامة لنحاسبك اللهم حسرك على ابناءك	NEG
عادي الدكتوره تجي متاخره ثلث ساعه  بس مو عادي الطالبه تتأخر ٥ دقايق #عشنا_وشفنا	NEG
تخيل انك تتشاجر في الشارع انت تضرب خصمك وهو يضربك ثم يظهر شخص لكى يفرق بينكما لكنك تكتشف انه يمسكك ليمكن خصمك منك هذا ما يحدث في مصر الان	NEG
الخازوق الإسبرطى	NEG
ممكن رئيس لسه جايب 51? من الأصوات في الإعادة ضد فل عليه بلاغات ممكن فجأة يلاقي 90? من نفس الشعب مؤيدين لديكتاتوريته؟	NEG
2) اعترف بالمطالب المشروعة المتعلقة بحكومة إنقاذ وطني وتعديل الدستور وتقنين وضع جماعة الإخوان كإطار للحوار، 3) أقر بإلزامية نتائج الحوار	POS
ثأر #سيد_بلال وغيره سيلاحققك أيها الأفاق #برهامى #شيوخ_السلاطين #تجار_دين	NEG
اللي يشوفك يتمنى يكون مثلك واللي يعرفك يحترمك ويحبك واللي يسمع عنك يتمنى يقابلك ! #حاول	POS
# اعجبني رأيكوان رفضت التعميم سلبا اتفق معك ان موروث مصر الحضاري هو نواه مشروع الوسط للبناء عليه	NEUTRAL
كل عام و أنتم بخير، تقبل الله منا و منكم صالح الأعمال	POS
يالله فورا أول ما أستعيد السيطرة على الدي إم نتفق بالكتير على يوم الأربعإنت واحشني جدا	POS
قرار وزير الثقافة يخالف قرار الإتحاد الدولي للمنتجين والسينمائيين في شأن عدم إسناد تنظيم مهرجان القاهرة لدكتور يوسف شريف رزق الله	NEG
حذار يا #عدلي_منصور ان تفرج عن #دومة كما طلب منك #ممدوح_حمزه ومن وقعوا ع بيانه من المهزأين الذين يطلبون التفريط فيما لا يملكون ولاتملك انت	NEUTRAL
يوم الوفاء للرئيس؟! مين وفاء دي؟ مش واخد بالي	NEG
#حملة_الا_يوسف_الحسينى #يوسف_الحسيني حرقهم علشان كاشفهم من زمان أويغلطة ومش هيكرروها تاني …	NEUTRAL
الاختيارات مش عاجبانى	NEG
اعلم أنه كلما نُزع منك في الأرض شيئا جميلاً سيخبئ لك شئ في السماء أجمل	POS
يارب اجعلها لليلةة فرح لعشاق العالمي بالتوفيق ي نصرنا #النصر_الشباب	POS
أتممت مهمتي كعضو لجنة تحكيم في مهرجان فينيسيا اليوم شاهدت 20 عرض وراضي بشكل عام عن نتيجة الأوريزونتي التي ستعلن في الختام كمان ساعتين	POS
كتر خيرهم فعلا بيصلحوا غلطة مش بتاعتهم	POS
أثبتت تجارب علمية أن مضموناً كالذي يقدمه رامز جلال يفسد الأطفال و ينخفض بمستوى ذكائهم و لهذا تمنعه دول متحضرة	NEG
مع اشراقة كل شمس نبدأ عملنا بروح نشيطة وهمة عالية ويد واحدة ونية متجددة أحلى صباح لأجمل متطوعين فى اعظم حملة	POS
الارهاب تطور وصار من الحكومات ترهب الناس بالتفجيرات ثم تعلن انهم ارهابيين ومن يقول لهالا الاعلام ملكها	NEG
لو أنت من الناس اللي لم تؤيد أو تسكت عن ظلم أو فشل سواء في فترات #مبارك أو #المجلس_العسكري و #مرسي و #السيسي، قول	NEG
هل يتم تنفيذ القانون على امراء السعودية السجون في السعودية مليئة بآلاف المظلومين لمجرد انهم غير سعوديين وخصومهم سعوديون هل نحب لمصر	NEG
تفاؤلى بنجاح ثورتنا نابع من ايماني بأن ( الله لا يضيع أجر من أحسن عملا) ولا يوجد أحسن وأعظم عملا من أن يضحي الشعب	POS
ميرسي يا يو…	POS
أشارك اليوم في مبادرة فودافون لمحو الأمية, العلم قوة, سفيرا للمبادرة ومتطوعا لتحقيق الهدف القومي بأن تصبح مصر بلا أمية	POS
سأتجه الآن إلى الملتزم (بين الحجر الأسود و باب الكعبة) هناك يستجاب الدعاء و هناك لصق النبي جسده بالكعبة و دعا الله كثيراً سأدعو لكم كثيراً	POS
الدعم الصهيوني للإخوان أهدافه منع حماس من الهجوم على اسرائيل صراع سني شيعي يمزق المنطقةضمان تخلف مصر الدائم تحت حكم الاخوان الفاشي الفاشل	NEG
ابراهيم عقل نموذجا! #	POS
يا رب فرج عنا اليوم هماً نراه بضعفنا كبير و هو برحمتك صغير	NEUTRAL
طب إيه المشكلة في أشغال طريق فاضي؟ عشان مين يعرف يتحرك بالضبط إذا الناس روحت؟	NEUTRAL
مصر رائدة التحولات الكبرى حسمت التحديات التي واجهت كل المنطقة كالغزو المغولي والبريطاني وستضع حداً للتيارالعلما…	POS
اللهم إني أعوذ بك من المزايدين والمزايدات الرجالة منهم والستات	NEG
الاخت الفاضلة حسين فهمى صاحبة أشهر مواقف سياسية ترفض المصالحة مع الاخوان لانهم قتلة حد يقول للامورة أم شعر دهبي بلاش انتى يا حلوة	NEUTRAL
إخلاء سبيل #سما_المصرى وتغريمها 20 ألف جنيه فى قضية بث قناة "#فلول"	NEG
شكرًا جزيلا	POS
الكلام من برا السلطة حمادة والكلام من جوه السلطة حمادة تانى خالص	NEUTRAL
إنت كإخوان عايزني أصدق فعلا إنك مؤمن بالتسامح والتنوع طب عيني عينك في تصريحات وجدي غنيم وشيوخ الطائفية اللي طلعتوهم منصة دعم الرئيس	NEUTRAL
واضح إن أمي دعت عليا وأنا صغير وقالتلي روح ربنا يفرّج عليك خلقو، قام ربنا طلعني مذيع #	POS
نعم انه #خالد_بن_الوليد رضي الله عنه يا من يفتخر ب #هتلر	POS
ندوة توقيع رواية "نادي السيارات" الليلة السبت السابعة مساءً بفرع مكتبة "أ" - داندي مول >> التفاصيل :	NEG
تدوينة هامة	POS
صحفي ألماني يروي تفاصيل ليلة مرعبة من التعذيب والإهانة بين المعتقلين المصريين في الأقسام والسجون	POS
#الوطن| "#الخارجية" تدين الاعتداءات #الإسرائيلية على المصلين في المسجد الأقصى	NEG
عرض الاسبوع 10 ألاف متابع #درر #حكم #حكمه #حكمة #ابيات #النصر #الهلال #الفتح #كلمات #كلمة #بوح #الاتحاد [2287315]	POS
ماعندي شي اسمه احترمني انا اكبر منك عندي شي اسمه تحترمني احترمك غير كذا جب #الحكومة	POS
#عيد_الأم يكفيني بقاء أمي حين يغيبون و حب أمي حين يتغيرون و قلب أمي إن غابت قلوبهم وهم حاضرون	POS
62 سي بي سي:جنايات #شبرا_الخيمة تقضي بمعاقبة سارقي سيارة القيادي الإخواني #محمد_البلتاجي بالسجن 10سنوات مع الشغل ههههههههه #	NEUTRAL
انهم يكتبونني بطل اكتوبر الفريق سعد الشاذلي يكتب عن الكذب على الشعب ورضوى عاشور تكتب عن الثورة بين اليأس والأمل	POS
خمس الاف #الامارات #الهلال #النصر #السعودية #الكويت #قطر #الرياض #مكة #رتويت # #دبي #الشارقة # #غرد_بصورة 168	NEG
682 #الراتب_مايكفي_الحاجة #الاتحاد #الهلال #النصر #الاهلي #مرسي	POS
لك منا كل احترام وتقدير يا اخلص وانظف وانقي رئيس وزراء في مصردهشام قنديل #اعتذروا_لهشام_قنديل #مرسي_رئيسي #انتخبوا_العرص #انصاف_الاخوان	NEG
احيي اخواني في حزب البناء والتنمية (الجماعة الاسلامية) علي موقفهم الوطني الرائع، حيث قدموا مصلحة الوطن علي انفسهم،وكانوا سببا في جمع الكلمة1	POS
